Signals	Package
ChkIn	gformula
EXPmixtureLEandUC_loglik	stcrmix
Fhat	m_stats
GGmixtureLEandUC_loglik	stcrmix
LNmixtureLEandUC_loglik	stcrmix
Mst_iter	m_stats
Smat	m_stats
WEmixtureLEandUC_loglik	stcrmix
__geoplot_layer	geoplot
_adjksm	adjksm
_api_read	wbopendata
_api_read_indicators	wbopendata
_binom	williams
_bsqregtrace	grqreg
_cauchyden	regmain
_cauchyevaluator	regmain
_cauchyreg	regmain
_char2dlg	ckvar
_ck4like	ckvar
_ckneeded	ckvar
_ckvarnext	ckvar
_compile_mata	malmq2
_countrymetadata	wbopendata
_cu_c0	cusum6
_cureregr8	cureregr8
_cureregr8_gen	cureregr8
_ddml_allcombos	ddml
_ddml_copy	ddml
_ddml_crossfit	ddml
_ddml_describe	ddml
_ddml_drop	ddml
_ddml_estimate_ate_late	ddml
_ddml_estimate_linear	ddml
_ddml_export	ddml
_ddml_extract	ddml
_ddml_nnls	ddml
_ddml_nnls_p	ddml
_ddml_overlap	ddml
_ddml_sample	ddml
_ddml_save	ddml
_ddml_use	ddml
_desspss	usespss
_diff	m_stats
_digdis	digdis
_ebin	alorenz
_egb2den	regmain
_egb2evaluator	regmain
_egb2reg	regmain
_eststo	estout
_eventgenvars	xtevent
_eventiv	xtevent
_eventivstatic	xtevent
_eventols	xtevent
_eventolsstatic	xtevent
_ex_adecomp	adecomp
_ex_drdecomp	drdecomp
_ex_skdecomp	skdecomp
_expevaluator	regmain
_expreg	regmain
_freduse	freduse
_freduse2	freduse
_fredweb	freduse
_ftruncreg_p	simarwilson
_het_did_gmm	drdid
_init_options	sls
_ipwlogit_svy	ipwlogit
_isograph	isograph
_ivcrc_estimator	ivcrc
_jprcout	contrast
_kdens	kdens
_laplaceden	regmain
_laplaceevaluator	regmain
_laplacereg	regmain
_lcauchyevaluator	regmain
_lcauchyreg	regmain
_ldecomp	ldecomp
_lnevaluator	regmain
_lnmor_svyb	lnmor
_lnmor_svyr	lnmor
_lnreg	regmain
_ltevaluator	regmain
_ltreg	regmain
_matau2	meta_analysis
_matchval	alorenz
_mi_ESTIMATE	mitools
_mi_RUBIN	mitools
_mi_unique	mitools
_mici_bin	mitools
_mpitb_assoc	mpitb
_mpitb_ctyselect	mpitb
_mpitb_est	mpitb
_mpitb_estcot	mpitb
_mpitb_gafvars	mpitb
_mpitb_refsh	mpitb
_mpitb_rframe	mpitb
_mpitb_set	mpitb
_mpitb_setwgts	mpitb
_mpitb_show	mpitb
_mpitb_stores	mpitb
_mrsvmat	mrtab
_mvis	mice
_nargs	subsim_2
_normalevaluator	regmain
_normalreg	regmain
_oaxaca9	oaxaca9
_olsci	grqreg
_parameters	wbopendata
_parmest	mitools
_pcmdif	pcmdif
_pecats	crtest
_pecats2	hoi
_pecatsal	alorenz
_prefix_display	twopm
_pyparse	pystacked
_qregsel	qregsel
_qregtrace	grqreg
_query	wbopendata
_query_indicators	wbopendata
_query_metadata	wbopendata
_regsen_breakfront_plot	regsensitivity
_regsen_display	regsensitivity
_regsen_idset_plot	regsensitivity
_regsen_write_scalar_table	regsensitivity
_regsen_write_table_header	regsensitivity
_regsen_write_tuples	regsensitivity
_robksm	adjksm
_scauchyden	regmain
_scauchyevaluator	regmain
_scauchyreg	regmain
_segb2den	regmain
_segb2evaluator	regmain
_segb2reg	regmain
_set2logic	ckvar
_sgedden	regmain
_sgedevaluator	regmain
_sgedreg	regmain
_sgtden	regmain
_sgtevaluator	regmain
_sgtreg	regmain
_slaplaceden	regmain
_slaplaceevaluator	regmain
_slaplacereg	regmain
_snormalden	regmain
_snormalevaluator	regmain
_snormalreg	regmain
_spreg_gs2sls	sppack
_spreg_ml	sppack
_sqregtrace	grqreg
_sspecialreg	sspecialreg
_stata2logic	ckvar
_staticfc	staticfc
_stddiff	stddiff
_stden	regmain
_stevaluator	regmain
_streg	regmain
_subsim_inst	subsim
_subsim_menu	subsim_2
_subsim_vers	subsim
_svm_model2stata	svmachines
_svm_train	svmachines
_svy_tpm_display	tpm
_svy_twopm_display	twopm
_sw_lik	switchr
_sw_lik2	switchr
_tden	regmain
_tesen_cpi	tesensitivity
_tesen_cscale	tesensitivity
_tesen_display	tesensitivity
_tesen_estat	tesensitivity
_tesen_plot	tesensitivity
_tevaluator	regmain
_tknz	wbopendata
_treg	regmain
_ttest	sdtest
_update_countrymetadata	wbopendata
_update_indicators	wbopendata
_update_wbopendata	wbopendata
_usespss	usespss
_wbod_tmpfile1	wbopendata
_wbod_tmpfile2	wbopendata
_wbod_tmpfile3	wbopendata
_website	wbopendata
_welcom_inst	welcom
_welcom_vers	welcom
_xthck	xtheckmanfe
_xthckiv	xtheckmanfe
_xtspecialreg	sspecialreg
a2group	a2reg
a2reg	a2reg
aaniv	aaniv
aaplot	aaplot
abar	abar
abg	abg
absdid	absdid
ac2	panelauto
acelong	acelong
acplot	acplot
acprplots	cprplots
acreg	acreg
acregpackcheck	acreg
actest	actest
actest9	actest
addSMenu	subsim_2
addbefore	addbefore
addinby	addinby
addnotes	addnotes
addplot	addplot
addshare	readshare
addtex	addtex
addtxt	addtxt
adecomp	adecomp
adelong	acelong
adfmaxur	adfmaxur
adftest	adftest
adjacent	adjacent
adjksm	adjksm
adjl	egenmore
adjmean	adjmean
adjprop	adjprop
adjtest	mmsel
adju	egenmore
adjust	adjust
adjustrcspline	postrcspline
adjustrcspline_ex	postrcspline
admetan	admetan
admetan_hlp_run	admetan
admetani	admetan
adodev	adodev
adoedit	adoedit
adofac	adodev
adoind	adodev
adoins	adodev
adoinstall	adoinstall
adolist	adolist
adorestore	adostore
adostore	adostore
adotype	adotype
aedot	aedot
aedots	aedot
aedots2	aedot
aefdr	aefdr
aei	rpaxioms
aelong	acelong
aevolcano	aevolcano
aevolcs	aevolcano
aextlogit	aextlogit
affiliationexposure	affiliationexposure
aggind	aggind
aggreg	itsp_ado
aggreg2	itsp_ado
aggrvar	subsim_1
agrm	agrm
aic_model_selection	aic_model_selection
ainequal	ainequal
airnet	airnet
ais_tmpm	icdpic
ajv	jnsn
akdensity	akdensity
akdensity0	akdensity
albatross	albatross
albatross_examples	albatross
alignedpairs	alignedpairs
alignedranks	alignedranks
alignedsets	alignedsets
alignmicro	alignmicro
allcross	allcross
allpossible	allpossible
allsubsets	allsubsets
allsynth	allsynth
alluvial	alluvial
almon	almon
almon1	almon1
alogit	alogit
alogit_p	alogit
alogit_p_fast	alogit
alogit_sim	alogit
alorenz	alorenz
alphawgt	alphawgt
alphlist	listutil
alsmle	alsmle
altcharl	icdpic
altfrdbwselect	rdmse
altrdbwselect	rdmse
altrdvce	rdmse
ameta	ameta
ammaevaluator	regmain
ammareg	regmain
anaoption	loevh
ancestor	dag
anketest	anketest
anogi	anogi
anovaplot	modeldiag
anovaplot7	modeldiag
anymatch	anymatch
anythingtodate	anythingtodate
aov1cont	contrast
apc_cglim	apc
apc_ie	apc
apcd	apcd
apcgo	apcgo
apch	apch
apctlag	apcgo
apctlagb	apcgo
apoverty	apoverty
appendfile	appendfile
appendgz	gziputil
apport	_gapport
approx	python
aprlb	persuasio
aprub	persuasio
aps	icdpic
archlm	archlm
archlm2	panelauto
archqq	archqq
arcplot	arcplot
ardl	ardl
ardl_estat	ardl
ardl_p	ardl
ardlbounds	ardl
arhomme	arhomme
ari	sadi
arimaauto	arimaauto
arimafit	arimafit
arimasel	arimasel
arjas_example	starjas
armadiag	armadiag
armaroots	armaroots
arrowplot	arrowplot
art2bin	art
artbin	artbin
artest	boottest
artformatnos	art
artmenu	art
artpep	art
artsurv	art
ascii	ascii
ascii2unicode	unicode2ascii
asciiplot	asciiplot
ascol	ascol
ascot	icdpic
ascvd	ascvd
ascvdi	ascvd
asdbsave	subsim_1
asdoc	asdoc
asgen	asgen
ashell	ashell
asinhasinh	cdfquantreg
asinhasinhinnerv2	cdfquantreg01
asinhasinhinnerv3	cdfquantreg01
asinhasinhinnerw2	cdfquantreg01
asinhasinhinnerw3	cdfquantreg01
asinhasinhouterv2	cdfquantreg01
asinhasinhouterv3	cdfquantreg01
asinhasinhouterw2	cdfquantreg01
asinhasinhouterw3	cdfquantreg01
asinhburr7	cdfquantreg
asinhburr8	cdfquantreg
asinhcauchy	cdfquantreg
asinhcauchyinnerv2	cdfquantreg01
asinhcauchyinnerv3	cdfquantreg01
asinhcauchyinnerw2	cdfquantreg01
asinhcauchyinnerw3	cdfquantreg01
asinhcauchyouterv2	cdfquantreg01
asinhcauchyouterv3	cdfquantreg01
asinhcauchyouterw2	cdfquantreg01
asinhcauchyouterw3	cdfquantreg01
asinhlogistic	cdfquantreg
asinht2	cdfquantreg
asl_norm	asl_norm
asl_norm_ex	asl_norm
asreg	asreg
asrol	asrol
assertky	assertky
astile	astile
astx	astx
asubini	subsim_1
asubini2	subsim_1
asubsim	subsim_1
atan2	circular
atspec	icalc
attregtest	attregtest
audit_cc	audit_cc
autofill	autofill
autofmt	autofmt
autolog	autolog
autorename	autorename
autosum	autosum
avar	avar
avar9	avar
avciplot	avciplot
avciplots	avciplot
avg_effect	avg_effect
avgper	itsp_ado
avplot2	avplot2
avplot3	avplot3
avplots2	avplot2
avplots4	avplots4
avplots4_7	avplots4
axis	egenmore
axisdigit	icalc
b	bacondecomp
b1x2	b1x2
b2evaluator	regmain
b2reg	regmain
ba	bacondecomp
babibplot	babibplot
bac	bacondecomp
backrasch	backrasch
backtest	mvport
baco	bacondecomp
bacon	bacondecomp
baconde	bacondecomp
bacondec	bacondecomp
bacondeco	bacondecomp
bacondecom	bacondecomp
bacondecomp	bacondecomp
badiag	baplot
baing	baing
balancetable	balancetable
bandplot	bandplot
baplot	baplot
barplot	barplot
barplot2	barplot2
barxlinedraw	icalc
baryhat	icalc
base	egenmore
basetable	basetable
basetable_example_data	basetable
basicstats	subsim_1
batcher	batcher
batplot	batplot
bayerhanck	bayerhanck
bayesmixedlogit	bayesmixedlogit
bayesmixedlogitwtp	bayesmixedlogitwtp
bayesmlogit	bayesmlogit
bcib	bcii
bcii	bcii
bcoeff	bcoeff
bcoeffs	bcoeffs
bcss	bcss
bcstats	bcstats
bctobit	bctobit
bcuse	bcuse
bdiff	bdiff
beamplot	beamplot
benford	benford
beta4	betafit
betacoef	betacoef
betafit	betafit
betafit_ex	betafit
betafit_lf	betafit
betafit_p	betafit
betaprior	betaprior
betareg_lf	betafit
betterbar	betterbar
betterbarci	betterbar
bfit	poparms
bfmcorr	bfmcorr
bgodfrey2	panelauto
bgshade	bgshade
bgtest	bgtest
bhatt	bhatt
biascon	biasepi
biasconi	biasepi
biasmis	biasepi
biasmisi	biasepi
biasselect	biasepi
biasselecti	biasepi
biassurvi	biasepi
biastab2	biasepi
bibrep	bibrep
bic	bic
bicdrop1	bicdrop1
bidensity	bidensity
bigtab	bigtab
bihist	bihist
bilgen	mmsel
bimap	bimap
bineq	bineq
bineqdiff	bineq
binolist	listutil
binscatter	binscatter
binscatterhist	binscatterhist
bioprobit	bioprobit
bioprobit_d2	bioprobit
bioprobit_p	bioprobit
biplot	biplot
biplot5	biplot
biplotvlab	biplotvlab
bipolar	bipolar
bipolate	bipolate
biprobit_fixedrho	fixedrho
biprobit_fixedrho_lf	fixedrho
birthsim	birthsim
bitobit	bitobit
bitobit_ll	bitobit
bivpoisson	bivpoisson
bking	bking
bking8	bking
bkrosenblatt	bkrosenblatt
blandaltman	blandaltman
blinding	blinding
blist	blist
block_and_cluster_ra	randomizr
block_ra	randomizr
blockdes	dcreate
blogit2	blogit2
blp	blp
bmi	bmi
bmii	bmi
bmjcip	bmjcip
bmp2dta	bmp2dta
bnormpdf	bnormpdf
boilerplate	mkproject
bollenstine	confa
bom	egenmore
bomd	egenmore
boost	boost
boost_predict	boost
boot_drf	ctreatreg
bootsamb	silvermtest
bootstrap_xtdcce2	xtdcce2
boottest	boottest
boottest_1	boottest
bothlist	listutil
boxcoxsim	ros
boxpanel	boxpanel
boxtid	boxtid
bpagan	bpagan
bpass	bpass
bpdifmed	bpmedian
bpmedian	bpmedian
brain	brain
brewcbsim	brewscheme
brewcolordb	brewscheme
brewcolors	brewscheme
brewdb	brewscheme
brewextra	brewscheme
brewlibcheck	brewscheme
brewmeta	brewscheme
brewproof	brewscheme
brewscheme	brewscheme
brewsearch	brewscheme
brewterpolate	brewscheme
brewtheme	brewscheme
brewtransform	brewscheme
brewviewer	brewscheme
brglm	brglm
brmunid	brmunid
bronch	bronch
bronchi	bronch
brr_hadamardmatrixfile	survwgt
bsens	bsens
bsopm	bsopm
bspline	bspline
bsrifhdreg	rif
buchinsky	mmsel
buckley	buckley
bugsdat	bugsdat
bugwrite	bugwrite
build_cond_expectation_1	fuzzydid
build_cond_expectation_2	fuzzydid
build_stpm2_mlib	stpm2
bumparea	bumparea
bumpline	bumpline
bunchbounds	bunching
bunchfilter	bunching
bunching	bunching
bunchtobit	bunching
bunchtobit_tloglike	bunching
bundle	bundle
burr7asinh	cdfquantreg
burr7burr7	cdfquantreg
burr7burr8	cdfquantreg
burr7cauchy	cdfquantreg
burr7logistic	cdfquantreg
burr7t2	cdfquantreg
burr8asinh	cdfquantreg
burr8burr7	cdfquantreg
burr8burr8	cdfquantreg
burr8cauchy	cdfquantreg
burr8logistic	cdfquantreg
burr8t2	cdfquantreg
butterworth	butterworth
bygap	bygap
byhist	byhist
bynote	bynote
bys	bys
bystore	bystore
byvar	byvar
c	fastcd
c_ml_stata_cv	c_ml_stata_cv
c_ml_stata_default	c_ml_stata_cv
cal	cal
cal2spell	sadi
calc4persuasio	persuasio
calibest	calibest
calibrate	calibrate
calinski	calinski
calipmatch	calipmatch
callCcode	ggt
calldiagram	diagram
callsado	callsado
callst	lowyseattlea
canon	canon
capass	capass
caplog	logout
care	care
carryforward	carryforward
cart	cart
carts	cart
casefat	casefat
catenate	catenate
caterpillar	caterpillar
catgraph	catgraph
catplot	catplot
catplot_old	catplot
cauchitasinh	cdfquantreg
cauchitasinhinnerv2	cdfquantreg01
cauchitasinhinnerv3	cdfquantreg01
cauchitasinhinnerw2	cdfquantreg01
cauchitasinhinnerw3	cdfquantreg01
cauchitasinhouterv2	cdfquantreg01
cauchitasinhouterv3	cdfquantreg01
cauchitasinhouterw2	cdfquantreg01
cauchitasinhouterw3	cdfquantreg01
cauchitburr7	cdfquantreg
cauchitburr8	cdfquantreg
cauchitcauchy	cdfquantreg
cauchitcauchyinnerv2	cdfquantreg01
cauchitcauchyinnerv3	cdfquantreg01
cauchitcauchyinnerw2	cdfquantreg01
cauchitcauchyinnerw3	cdfquantreg01
cauchitcauchyouterv2	cdfquantreg01
cauchitcauchyouterv3	cdfquantreg01
cauchitcauchyouterw2	cdfquantreg01
cauchitcauchyouterw3	cdfquantreg01
cauchitlogistic	cdfquantreg
cauchitt2	cdfquantreg
causaldata	causaldata
cb2html	cb2html
cbacktest	mvport
cbarplot	cbarplot
cbplot	icalc
ccmatch	ccmatch
ccmpre	ccmpre
cctable	cctable
ccweight	ccweight
cddens	cddens
cdecompose	cdecompose
cdfplot	cdfplot
cdfquantreg	cdfquantreg
cdfquantreg01	cdfquantreg01
cdfquantreg01_mf	cdfquantreg01
cdfquantreg01_p	cdfquantreg01
cdfquantreg_m	cdfquantreg
cdfquantreg_p	cdfquantreg
cdist	cdist
cdl	lowyseattlea
cdo	cdo
cdout	cdout
cdreg	cdreg
cedesign	cedesign
cem	cem
cemimix	cemimix
cendif	somersd
cenegbinll	censornb
cenpois	cenpois
censlope	somersd
censornb	censornb
censusapi	censusapi
centcalc	centcalc
center	center
centervars	itsp_ado
centpow	centpow
centroid	centroid
cepois	cepois
cepois_ll	cepois
ceq	ceq
ceq_parse_using	ceq
ceqassump	ceq
ceqconc	ceq
ceqcov	ceq
ceqcoverage	ceq
ceqdes	ceq
ceqdientropy	ceq
ceqdifgt	ceq
ceqdigini	ceq
ceqdinineq	ceq
ceqdom	ceq
ceqdomext	ceq
ceqeduc	ceq
ceqef	ceq
ceqefext	ceq
ceqextend	ceq
ceqextpop	ceq
ceqextsig	ceq
ceqfi	ceq
ceqfiscal	ceq
ceqgraph	ceq
ceqgraph_cdf	ceq
ceqgraph_conc	ceq
ceqgraph_fi	ceq
ceqgraph_progressivity	ceq
ceqhhchar	ceq
ceqindchar	ceq
ceqinfra	ceq
ceqiop	ceq
ceqlorenz	ceq
ceqmarg	ceq
ceqpop	ceq
ceqppp	ceq
ceqrace	ceq
ceqstatsig	ceq
ceqtarget	ceq
cext	mmsel
cf2	cf2
cf3	cf3
cf_exp	wtd
cfby	cfby
cfitzrw	cfitzrw
cflpois	cflpois
cfout	cfout
cfvars	cfvars
cgmwildboot	clustse
cgroup	cgroup
cgssm	cgssm
cgssmi	cgssm
chaid	chaid
chaidforest	chaidforest
chaidforest_estat	chaidforest
chaidforest_pr	chaidforest
change	cart
changemean	changemean
chaos	chaos
charcopy	charutil
chardef	chardef
chardel	charutil
charlist	charlist
charlson	charlson
charon	charon
chartab	chartab
chartab_run	chartab
chartabb	chartab
charto6	charutil
charundef	chardef
chatgpt	chatgpt
check7z	gziputil
checkax	rpaxioms
checkfor2	checkfor2
checkipaddresses	checkipaddresses
checkreg3	checkreg3
checkrob	checkrob
checkvar	checkvar
chesspos	chesspos
chesspuzzle	chesspuzzle
chewfile	chewfile
child	dag
childc	dag
chimchar	chimchar
chinaaddress	chinagcode
chinafin	chinafin
chinagcode	chinagcode
chiplot	chiplot
chitest	tab_chi
chitest6	tab_chi
chitesti	tab_chi
chitesti6	tab_chi
chlist	lowyseattleb
chm	chm
choi_lr_hyperg_prob	choi_lr_test
choi_lr_hypergeom	choi_lr_test
choi_lr_support_interval	choi_lr_test
choi_lr_support_interval_big_or	choi_lr_test
choi_lr_support_interval_or_eq_0	choi_lr_test
choi_lr_test	choi_lr_test
choi_lr_testi	choi_lr_test
choplist	listutil
chowgmmstar3	gcrobustvar
chowreg	chowreg
chowtest	chowtest
chunky	chunky
chunky8	chunky8
ci2	ci2
ci_fixed	singlearm
ci_gs	singlearm
ci_marg_mu	ci_marg_mu
cibar	cibar
cibplot	cibplot
cic	cic
cid	cid
ciform	ciform
cifunction	cifunction
cifunction_ex	cifunction
cihplot	cihplot
cii2	ci2
cij	cij
ciji	cij
ciplot	ciplot
cipolate	cipolate
circbw	circularkde
circcentre	circular
circcorr	circular
circdiff	circular
circdplot	circular
circdpvm	circular
circgph	circularkde
circhist	circular
circhistogram	circular
circkde	circularkde
circkden	circularkde
circkdensity	circular
circlccorr	circular
circlebar	circlebar
circlepack	circlepack
circmedian	circular
circovmean	circular
circovstr	circular
circpvm	circular
circqqplot	circular
circqvm	circular
circrao	circular
circrplot	circular
circsc	circular
circscatter	circular
circsu	circular
circsummarize	circular
circtwosample	circular
circvm	circular
circvplot	circular
circwarp	circularkde
circwwmardia	circular
circxlowess	circular
circylowess	circular
cirkdevm	circularkde
cisd	cisd
cisd1	cisd
cistat	cistat
civplot	civplot
ciw	ciw
ciwi	ciw
ciwidth_cmd_proportions_mc	ciwidth_proportions_mc
ciwidth_cmd_proportions_mc_init	ciwidth_proportions_mc
ckcodebook	ckvar
ckdrop	ckvar
ckkeep	ckvar
ckrename	ckvar
ckvar	ckvar
ckvarclear	ckvar
ckvardo	ckvar
ckvaredit	ckvar
ckvareditsave	ckvar
ckvarupdate	ckvar
clan	clan
classplot	classplot
classtab	classtab
classtabi	classtabi
clchi2	cltest
clean_class	clean_class
clean_name	clean_name
cleanchars	cleanchars
cleanlog	cleanlog
clearl	lowyseattlea
clemao1	clemao_io
clemao2	clemao_io
clemio1	clemao_io
clemio2	clemao_io
clhet_d2	clogithet
clickout	dirtools
clipline	clipgeo
clippolygon	clipgeo
clippolyline	clipgeo
clogithet	clogithet
clore	subsim_1
clorenz	clorenz
closedesc	lookfor2
clr	clrbound
clr2	clrbound
clr2b	clrbound
clr2bo	clrbound
clr2bou	clrbound
clr2bound	clrbound
clr3	clrbound
clr3b	clrbound
clr3bo	clrbound
clr3bou	clrbound
clr3boun	clrbound
clr3bound	clrbound
clr_b	clrbound
clr_k	clrbound
clr_kb	clrbound
clr_p	clrbound
clr_pb	clrbound
clr_s	clrbound
clrb	clrbound
clrbo	clrbound
clrbou	clrbound
clrboun	clrbound
clrbound	clrbound
clrtest	clrbound
clsort	_gclsort
clsst	egenmore
clstop_lbt	clstop_lbt
clttest	cltest
clump	clump
clus_nway	clus_nway
cluster	cluster
cluster2	cluster2
cluster3	cluster3
cluster_ra	randomizr
clusterbs	clusterbs
clustergram	clustergram
clustergram_examples	clustergram
clustersampsim	clustersampsim
clustpop	clustpop
clustse	clustse
clustsens	clustsens
clv	clv
cm2in	cm2in
cmatch	cmatch
cmaxuse	cmaxuse
cmdchk	ice
cme	cme
cmi_i	cmitest
cmi_in	cmitest
cmi_int	cmitest
cmi_inte	cmitest
cmi_inter	cmitest
cmi_interv	cmitest
cmi_interva	cmitest
cmi_interval	cmitest
cmi_t	cmitest
cmi_te	cmitest
cmi_tes	cmitest
cmi_test	cmitest
cmline	mvport
cmogram	cmogram
cmp	cmp
cmp_clear	cmp
cmp_p	cmp
cmpmargins	combomarginsplot
cnaddress	cngcode
cnar	cnar
cnborder	cnborder
cnbreg	cnbreg
cndnmb3	cndnmb3
cnevent	cnevent
cngcode	cngcode
cngdf	cngdf
cnindex	cnindex
cnintraday	cnintraday
cnkchart	cnkchart
cnmapsearch	cnmapsearch
cnormp	cnormp
cnpoi	cnpoi
cnpoislf	cenpois
cns	cns
cnsprobit	mmsel
cnsrsig	cnsrsig
cnssc	cnssc
cnstock	cnstock
cnstroke	cnstroke
cnt	lowyseattleb
cntop10	cntop10
cntrade	cntrade
cntraveltime	cntraveltime
cochran	cochran
codci	codci
codebook2	codebook2
codebook_ripper	codebook_ripper
codebookout	codebookout
codes	weaver
coefplot	coefplot
cohend	cohend
coldiag	coldiag
coldiag2	coldiag2
colelms	colelms
collapse2	collapse2
collapsel	lowyseattlea
collapseunique	collapseunique
collect	lowyseattlea
collist	listutil
color_brewer	color_style
color_brewer9	color_style
color_style	color_style
colorcheck	palettes
colorpalette	palettes
colorpalette9	palettes
colorscatter	colorscatter
combin	percom
combinadd	sadi
combinatorics	combinatorics
combine	combine
combineplot	combineplot
combinprep	sadi
combival	combival
combomarginsplot	combomarginsplot
combomarginsplot12	combomarginsplot
combomp	combomarginsplot
combreg	sensimatch
complete_ra	randomizr
complexity	complexity
complogit	complogit
complogitml	complogit
comtrade	comtrade
concindc	concindc
concindexg	concindex
concindexi	concindex
concord	concord
concordance	concordance
conddens	conddens
condisc	condisc
condmix	conddens
confa	confa
confa_estat	confa
confa_lfm	confa
confa_p	confa
confall	confall
confirmdir	confirmdir
confmat	matrixtools
confnd	confnd
confsvy	confsvy
conindex	conindex
conjoint	conjoint
conplot	icalc
contour	contour
contrasi	contrast
contrast	contrast
contyhat	icalc
convdate	numdate
convert_top_lines	convert_top_lines
convlist	listutil
cooksd2	cooksd2
copycode	copycode
copydesc	copydesc
coranal	coranal
corr	egenmore
corr2docx	corr2docx
corr_svy	corr_svy
corrsqm	sadi
corrtab	corrtab
corrtable	corrtable
corrtex	corrtex
corsp	corsp
cortesti	cortesti
cospectdens	cospectdens
couliari	couliari
countmatch	countmatch
countvalues	countvalues
countyfips	countyfips
countyfips_data	countyfips
cov	egen_inequal
covariancemat	mahapick
covbal	covbal
covconc	ceq
cpcorr	cpcorr
cpcorr6	cpcorr
cpigen	cpigen
cpiget	cpiget
cpoisll	cpoisson
cpoisson	cpoisson
cpoissone	cpoissone
cpoisxll	cpoissone
cpr	cpr
cprd_additional	cprdutil
cprd_batchnumber	cprdutil
cprd_bnfcodes	cprdutil
cprd_browser_medical	cprdutil
cprd_browser_product	cprdutil
cprd_clinical	cprdutil
cprd_common_dosages	cprdutil
cprd_consultation	cprdutil
cprd_entity	cprdutil
cprd_immunisation	cprdutil
cprd_medical	cprdutil
cprd_nonxyzlookup	cprdutil
cprd_packtype	cprdutil
cprd_patient	cprdutil
cprd_patientobs	cprdutil
cprd_practice	cprdutil
cprd_product	cprdutil
cprd_referral	cprdutil
cprd_scoremethod	cprdutil
cprd_staff	cprdutil
cprd_test	cprdutil
cprd_therapy	cprdutil
cprd_xyzlookup	cprdutil
cprdent_1	cprdentutil
cprdent_13	cprdentutil
cprdent_14	cprdentutil
cprdent_147	cprdentutil
cprdent_163	cprdentutil
cprdent_175	cprdentutil
cprdent_177	cprdentutil
cprdent_26	cprdentutil
cprdent_4	cprdentutil
cprdent_5	cprdentutil
cprdent_87	cprdentutil
cprdentcode	cprdenttype
cprdenttype	cprdenttype
cprdhes_acp	cprdhesutil
cprdhes_ccare	cprdhesutil
cprdhes_diagnosis_epi	cprdhesutil
cprdhes_diagnosis_hosp	cprdhesutil
cprdhes_episodes	cprdhesutil
cprdhes_hospital	cprdhesutil
cprdhes_hrg	cprdhesutil
cprdhes_maternity	cprdhesutil
cprdhes_patient	cprdhesutil
cprdhes_primary_diag_hosp	cprdhesutil
cprdhes_procedures_epi	cprdhesutil
cprdhesae_attendance	cprdhesaeutil
cprdhesae_diagnosis	cprdhesaeutil
cprdhesae_hrg	cprdhesaeutil
cprdhesae_investigation	cprdhesaeutil
cprdhesae_pathway	cprdhesaeutil
cprdhesae_treatment	cprdhesaeutil
cprdhesop_appointment	cprdhesoputil
cprdhesop_clinical	cprdhesoputil
cprdhesop_patient_pathway	cprdhesoputil
cprdlink_linkage_coverage	cprdlinkutil
cprdlink_linkage_eligibility	cprdlinkutil
cprdlink_linked_practices	cprdlinkutil
cprdlsoa_patient_index	cprdlsoautil
cprdons_death_patient	cprdonsutil
cpredict	cpredict
cprplot2	cprplot2
cprplots	cprplots
cprplots2	cprplot2
cpspear	cpcorr
cpspear6	cpcorr
cptest	cvcrand
cpyxplot	cpyxplot
cpyxplot6	cpyxplot
cqiv	cqiv
cquadbasic	cquad
cquadbasicr	cquadr
cquadequ	cquad
cquadequr	cquadr
cquadext	cquad
cquadextr	cquadr
cquadpseudo	cquad
cquadpseudor	cquadr
cquantile	cquantile
crater	crater
createpkgdlg	installpkg
createsharedesc	readshare
createtocdlg	installpkg
creplace	creplace
crhdreg	crhdreg
critiband1	silvermtest
crm	crm
crossfit	ddml
crossfold	crossfold
crossmat	matrixtools
crossplot	crossplot
crossv	crossvalidate
crossvalidate	crossvalidate
crtbayes	eefanalytics
crtest	crtest
crtfreq	eefanalytics
crtrees	crtrees
crtrees_p	crtrees
cs_exp	wtd
csdid	csdid
csdid_estat	csdid
csdid_plot	csdid
csdid_rif	csdid
csdid_stats	csdid
csdid_table	csdid
cseplist	listutil
csgvar	csdid
csipolate	csipolate
csjl	csjl
csranks	csranks
cstable	cstable
csti	csti
csvconvert	csvconvert
cta	cta
ctabstat	ctabstat
ctreatreg	ctreatreg
ctrstr	icalc
cub	cub
cub14	cub
cub14s	cub
cuentacot	cuentacot
cumuldur	sadi
cureregr	cureregr
cureregr8	cureregr8
cureregr_gen_p	cureregr
cureregr_p	cureregr
curvefit	curvefit
curvnpe	subsim_1
cusum6	cusum6
cusum9	cusum9
cut	_gcut
cut5	_gcut
cutpt	cutpt
cv	cv
cv2	cv2
cv_kfold	cv_kfold
cv_regress	cv_regress
cvar	cart
cvarlist	listutil
cvauroc	cvauroc
cvcrand	cvcrand
cvlasso	lassopack
cvlassologit	lassopack
cvxhull	cvxhull
cvxindex	cvxhull
cvxplot	cvxhull
cwmbootstrap	cwmglm
cwmglm	cwmglm
cwmglm_predict	cwmglm
cycleplot	cycleplot
d2	egenmore
d3network	d3network
dadjoke	dadjoke
dagfit	dagfit
dagfit_ll	dagfit
dagumfit	dagumfit
dagumfit_ll	dagumfit
dagumpred	dagumfit
dash	dash
dashgph	dashgph
dashln	dashln
datacheck	datacheck
dataex	dataex
datanet	datanet
dataout	dataout
dataplink	dataplink
datelist	datelist
datesum	datesum
datmat	datmat
dayofyear	egenmore
dbetafit	betafit
dbins	m_stats
dbmscopybatch	dbmscopybatch
dbnomics	dbnomics
dcreate	dcreate
dd	lowyseattlea
ddf2dct	ddf2dct
ddirifit	dirifit
ddml	ddml
ddt	lowyseattleb
deci	deci
decide_winner	winratiotest
decimal	egenmore
decomp	decomp
decompose	decompose
decompress	sortrows
defaxislab	icalc
defdualaxislab	icalc
defdualaxislabbar	icalc
definefm	icalc
deg2rad	sphdist
del	lowyseattlea
delaunay	delaunay
dellist	listutil
delta	delta
demotivate	demotivate
density	egenmore
density2	psmatch2
denton	denton
denton7	denton
dentonmq7	denton
dep4asm	dep4asm
dependencies	dependencies
depthplot	depthplot
des10	use10
des2	des2
des_admissable	singlearm
des_bayesfreq	singlearm
des_curtailed	singlearm
des_dtl	desma
des_fixed	singlearm
des_gehan	singlearm
des_gs	singlearm
des_ma	desma
des_mams	desma
descgen	descgen
desclong	desclong
descogini	descogini
descsave	descsave
designplot	designplot
desmat	desmat
desrep	desmat
desspss	usespss
destest	desmat
detangle	gformula
detect	detect
devcon	devcon
devnplot	devnplot
devr2	devr2
dfao	dfao
dfgls	dfgls
dfgls2	panelunit
dfl	dfl
dfmlogit	fmlogit
dfsummary	dfsummary
dftol	dftol
dftolgraph	dftol
dftolss	dftol
dfuller2	panelunit
dgraph	dgraph
dhms	egenmore
diagma	diagma
diagram	diagram
diagramconnection	diagram
diagramnode	diagram
diagreg	diagreg
diagreg2	diagreg2
diagsampsi	diagsampsi
diagt	diagt
diagtest	diagtest
diagti	diagt
dichoct	dichoct
dicseg	segregation
dict	dict
did2s	did2s
did_imputation	did_imputation
did_multiplegt	did_multiplegt
didq	didq
difF_iter	m_stats
difd	difd
difdetect	difdetect
diff	diff
diffbs	diff
difflist	listutil
diffpi	diffpi
difwithpar	difwithpar
digdis	digdis
digit	digits
digituse	digits
diplot	diplot
diptest	diptest
directma	directma
dirfile	brewscheme
dirifit	dirifit
dirifit_ex	dirifit
dirifit_lf	dirifit
dirifit_p	dirifit
dirireg_lf	dirifit
dirlist	dirlist
dirmul	groupcl
dirmul1_ll	groupcl
dirmul2_ll	groupcl
dirtree	dirtree
discrates	discrates
discrepancy	discrepancy
disjoint	disjoint
dissim	dissim
dissim_index	dissim
distable	subsim_1
distan	distan
distcomp	distcomp
distcomp2var	distcomp2var
distinct	distinct
distmatch	distmatch
distplot	distplot
distplot7	distplot
distrate	distrate
distrate_example	distrate
div	weaver
divcat	divcat
divprob	ivprob-ivtobit6
divratio	divratio
dkdensity	dkdensity
dlagif	dlagif
dlist	dlist
dmariano	dmariano
dmerge	dmerge
dmexogxt	dmexogxt
dmout	dmout
do2docs	log2markup
do2screen	do2screen
docd	docd
dochar	ckvar
docharedit	ckvar
docxtab	docxtab
doiplot	doiplot
dolog	dolog
dolog10	dologx
dolog11	dologx
dolog12	dologx
dolog13	dologx
dolog14	dologx
dolog15	dologx
dolog16	dologx
dolog6	dologx
dolog7	dologx
dolog8	dologx
dolog9	dologx
domdiag	domdiag
domin	domin
domme	domme
doparser	doparser
doptimal	doptimal
doseresponse	doseresponse
doseresponse2	doseresponse2
doseresponse_model	doseresponse2
dosmcl	dolog
dotemplate	dotemplate
dotex	dotex
doub2flt	doub2flt
doubleb	doubleb
doubleb_ll	doubleb
doubletofloat	doubletofloat
doubletriangular	groupseq
doubmass	doubmass
dpplot	dpplot
dpplot7	dpplot
dpredict	dpredict
dqd	dqd
drany	lowyseattleb
drarea	drarea
drawwage	mmsel
drcate	drcate
drcatecv	drcate
drdecomp	drdecomp
drdid	drdid
drdid_display	drdid
drdid_predict	drdid
drm	drm
drm_logit_ll	drm
drm_normal_ll	drm
drm_probit_ll	drm
drmeta	drmeta
drmeta_cov	drmeta
drmeta_gof	drmeta
drmeta_graph	drmeta
drmeta_predict	drmeta
drmmws	drmmws
drmmws_bs	drmmws
ds2	ds2
ds3	ds3
ds5	ds5
dsconcat	dsconcat
dsearch	dsearch
dseg	dseg
dsginideco	dsginideco
dslab	labutil2
dstat	dstat
dstat_svyr	dstat
dsweight	dsweight
dta2ddi	dta2ddi
dta2html	dta2html
dta2kml	dta2kml
dta2md	dta2md
dta2sav	dta2sav
dtalink	dtalink
dtanotes	dtanotes
dtapaper	dtapaper
dtastamp	dtastamp
dthaz	dthaz
dtobit2	dtobit2
dualaxislabcontour	icalc
dubois_example	dubois
dudahart	dudahart
dummies	dummies
dummieslab	dummieslab
dummynizer	matrixtools
duncan	duncan
duncan2	duncan
duplist	dlist
dupneigh	spautoc
dupneigh5	spautoc
dups	dups
durbina2	panelauto
durbinh	durbinh
dview	viewresults
dwstat2	panelauto
dyadid	dyadid
dyads	dyads
dyn2do	stmd
dynardl	dynardl
dynhamming	sadi
dynpandoc	dynpandoc
dynsimpie	dynsimpie
eaalogit	eaalogit
eaapred	eaalogit
eacf	eacf
eba	eba
ebalance	ebalance
ebalfit	ebalfit
ebalfit_p	ebalfit
ebct	ebct
ebreg	ebreg
ebrowse	ebrowse
ecic	ecic
eclpci	eclpci
eclplot	eclplot
edden	regmain
edevaluator	regmain
edfreg	edfreg
edm	edm
edreg	regmain
educationdata	educationdata
ef	efolder
effcon	effcon
effdisp	icalc
effects1	effects
effmenu1	effects
effmenu2	effects
efolder	efolder
eformat	cart
efrontier	mvport
efrontierm	mvport
egfr	egfr
egi	egi
egranger	egranger
egroup	egenmore
eitc	eitc
elabel	elabel
elabel_cmd_adjust	elabel
elabel_cmd_compare	elabel
elabel_cmd_load	elabel
elabel_cmd_modify	elabel
elabel_cmd_recode	elabel
elabel_cmd_remove	elabel
elabel_cmd_rename	elabel
elabel_cmd_uselabel	elabel
elabel_fcn_combine	elabel
elabel_fcn_copy	elabel
elabel_fcn_encode	elabel
elabel_fcn_levels	elabel
elabel_fcn_regexse	elabel
elap	egenmore
elap2	egenmore
elapse	elapse
elasticregress	elasticregress
electind	electool
elfs	lowyseattle
elgen	lowyseattlea
elife	elife
elix22	elix22
elixhaus	icdpic
elixhauser	elixhauser
ellip	ellip
ellip6	ellip6
ellip7	ellip7
ellipticity	ellipticity
eltmle	eltmle
email	email
emailme	emailme
emc	emc
eme	runmplus
emh	emh
emiss	lowyseattleb
encodefrom	encodefrom
encodel	lowyseattleb
encodelabel	encodelabel
encoder	encoder
encoderall	encoder
enforce	enforce
enlarge	enlarge
entropy	entropy
entropyetc	entropyetc
env	genvars
enx	dfl
eofplot	eofplot
eoframe_generate_plevel	geoplot
eoframe_spjoin	geoplot
eom	egenmore
eomd	egenmore
eoplot_bar	geoplot
eoplot_label	geoplot
eoplot_pie	geoplot
eoplot_symbol	geoplot
eperiod	eperiod
epi_seir	epimodels
epi_sir	epimodels
epiconf	epiconf
epimodels	epimodels
epimodels_util	epimodels
episens	episens
episens_mcsa_all	episens
episens_mcsa_mie	episens
episens_mcsa_sel	episens
episens_mcsa_unc	episens
episensi	episens
episensrri	episensrri
epiweek	epiweek
epiweek2	epiweek
epresent	epresent
epsigr	epsigr
eqlist	listutil
eqndefine	icalc
eqprhistogram	eqprhistogram
equation	equation
er	er
erate	erate
ereplace	ereplace
erepost	erepost
eret2	eret2
errbplot	icalc
ersur	ersur
es_event_wrk_dlg	eventstudy
es_store_array	eventstudy
es_trade_wrk_dlg	eventstudy
esetran	esetran
esizereg	esizereg
esizeregi	esizereg
esli	esli
est2one	est2tex
est2rowlbl	est2tex
est2tex	est2tex
est2vec	est2tex
est_fixed	singlearm
est_gs	singlearm
estadd	estout
esteta	esteta
estfe	reghdfe
estim_wrapper	fuzzydid
estout	estout
estout1	estout1
estparm	estparm
estparm_p	estparm
estparmtest	estparm
estpost	estout
estquant	estquant
estrat	estrat
estread	estwrite
estsave	estsave
estsimp	clarify
eststo	estout
esttab	estout
estudy	estudy
estwrite	estwrite
et_version	malmq2
etcensus_catalog	getcensus
etcensus_expand_keyword	getcensus
etcensus_geo_args	getcensus
etcensus_parse_geography	getcensus
etime	etime
etmxdatabanxico	getmxdata
etmxdatabie	getmxdata
etregress_fixedrho	fixedrho
etregress_fixedrho_lf	fixedrho
etregress_fixedrho_po_lf	fixedrho
eucldist	m_stats
eurostatuse	eurostatuse
eurouse	eurouse
evaldes	dcreate
evalue	evalue
evalue_estat	evalue_estat
evalues	evalues
event_plot	event_plot
eventcoefplot	eventcoefplot
eventdd	eventdd
eventdd_estat	eventdd
eventstudy	eventstudy
eventstudy2	eventstudy2
eventstudy_wrk_dlg_event	eventstudy
eventstudy_wrk_dlg_trade	eventstudy
eventstudyinteract	eventstudyinteract
eventstudyweights	eventstudyweights
evhistplot	evhistplot
evi	evi
ewma	ewma
ewreg	ewreg
exampleobs	exampleobs
examples	examples
examples8	examples
exbsample	exbsample
excel2latex	excel2latex
excelclean	excelclean
excelclean_demo	excelclean
excelcol	excelcol
exceloutput	exceloutput
excelsave	excelsave
expand_n	expand_n
expandby	expandby
expandihlp	expandihlp
expandrank	expandrank
expgen	expgen
expl	expl
explist	explist
explorelabs	explorelabs
export_svmlight	svmachines
exptorcs	merlin
expy	expy
exquantile	exquantile
extend_opt_graph	subsim_1
extend_opt_price	subsim_1
extfunnel	extfunnel
extrdate	numdate
extreme	extreme
extreme_estimate	extreme
extreme_p	extreme
extreme_small	extreme
extremes	extremes
f_able	f_able
f_able_epilog	f_able
f_able_p	f_able
f_able_prolog	f_able
f_able_reset	f_able
f_rcspline	f_able
f_reg	f_able
f_spline	f_able
f_symev	f_able
f_symrv	f_able
faam	faam
fabplot	fabplot
factext	factext
factmerg	factmerg
factorn	factorn
factortest	factortest
factref	factref
fagan	fagan
fagani	midas
fairlie	fairlie
far5	far5
fastcc	copycode
fasterxtile	gtools
fastgini	fastgini
fastreshape	fastreshape
fastwpctile	egenmisc
fastxtile	fastxtile
favplot	favplots
favplots	favplots
fbar	fbar
fbep	fbep
fcollapse	ftools
fcstats	fcstats
fcstats2	fcstats
fdfilter	fdfilter
fdi	python
fdrisk	sgpv
fdta	fdta
fedit	fedit
fegen	ftools
fegen_group	ftools
feldti	feldti
fese	fese
fframeappend	fframeappend
fgen	f_able
fgt	egen_inequal
fgt_ci	fgt_ci
fgtest	fgtest
fhsae	fhsae
fi_fgp	fiscal_impoverishment
fi_fgp_graph	fiscal_impoverishment
fieldarea	fieldarea
fieller	fieller
fielleri	fieller
figout	tabout
filaby	matrixtools
filei	filei
filelist	filelist
filesearch	filesearch
filesys	brewscheme
fillmissing	fillmissing
filter	egenmore
filtertrace	filtertrace
find	find
find_denom	find_denom
find_index	find_index
findd	lowyseattlea
findda	lowyseattlea
finddat	lowyseattlea
finddata	lowyseattlea
finddup	finddup
findname	findname
findregex	findregex
findsysmis	findsysmis
findunique	findunique
findval	findval
first	egenmore
firstdigit	firstdigit
firthfit	firthfit
firthlogit	firthlogit
firthlogit_ll	firthlogit
fiscal_impoverishment	fiscal_impoverishment
fisid	ftools
fiskfit	fiskfit
fiskfit_lf	fiskfit
fitdom	domin
fitint	fitint
fitmacro	fitmacro
fitstat	fitstat
fitstat_ers	fitstat_ers
five_fold_cv	fuzzydid
fixsort	fixsort
flevelsof	ftools
flex	flex
flex_ml	flex
flex_ml1	flex
flexcurv	bspline
flexmat	flexmat
flexpaneldid	flexpaneldid
flexpaneldid_preprocessing	flexpaneldid
flipmat	itsp_ado
floatplot	floatplot
floattolong	floattolong
flowchart	flowchart
flower	flower
fmargins	f_able
fmerge	ftools
fmiss	fmiss
fmlogit	fmlogit
fmlogit_d2	fmlogit
fmlogit_ex	fmlogit
fmlogit_lf	fmlogit
fmlogit_p	fmlogit
fmlogit_pr	lclogit
fmm	fmm
fmm_gamma_lf	fmm
fmm_gamma_p	fmm
fmm_lognormal_lf	fmm
fmm_lognormal_p	fmm
fmm_negbin1_lf	fmm
fmm_negbin1_p	fmm
fmm_negbin2_lf	fmm
fmm_negbin2_p	fmm
fmm_normal_lf	fmm
fmm_normal_p	fmm
fmm_poisson_lf	fmm
fmm_poisson_p	fmm
fmm_studentt_lf	fmm
fmm_studentt_p	fmm
fmmhist	fmmhist
fmmlc	fmmlc
fmtlist	listutil
fndmtch	fndmtch
fndmtch2	fndmtch2
fns	cart
fod2str	fodstr
fodstr	fodstr
folders	fs
font_style	color_style
for211	for211
forest	forest
forestplot	metan
forfile	forfile
formatline	gformula
fourier	circular
foy	egenmore
fpcata	fpro
fpe	readwind
fpimpov	fpro
fprank	fprank
fpref	fpref
fqreg	fqreg
fqreg_ml0	fqreg
frac_154_wald	mfpmi
frac_s3b	stpm
frac_spl	stpm
frac_wald	mfpmi
fracdiff	fracdiff
fracdydx	fracdydx
fracirf	fracirf
fraclogit	fraclogit
fracrank	sgini
fractal	fractal
fractileplot	fractileplot
fraddinby	addinby
fragility	fragility
fragtextab	fragtextab
frameappend	frameappend
framingham	framingham
framingham30	framingham30
framinghami	framingham
frapply	frapply
frause	frause
frcount	frcount
frcount_bs	frcount
fre	fre
freduse	freduse
frencurv	bspline
frep	f_able
freplace	freplace
freq_total	multistate
freqindex	freqindex
freshape	ftools
frexp	wtd
fridit	wridit
frlnorm	wtd
frm	frm
frm_cauchit	frm
frm_ggoff	frm
frm_pe	frm
frm_ptest	frm
frm_reset	frm
frmttable	outreg
fromdummies	dummies2
fromeditor	lowyseattle
fromroman	roman
fromvars	lowyseattleb
frontier_teci	frontier_teci
frontierhtail	frontierhtail
frontierhtail_lf	frontierhtail
frontierhtail_lf1	frontierhtail
frontierhtail_p	frontierhtail
frqfocmod1	icalc
frqmod	icalc
frwei	wtd
fs	fs
fsdet	fsdet
fsort	ftools
fsum	fsum
fsx	fsx
ftab	ftools
ftest	ftest
ftocci	ftocci
ftools	ftools
ftrans	ftrans
ftruncreg	simarwilson
full_palette	full_palette
fulltab	fulltab
funcdep	collapseunique
funnel	metaaggr
funnelcompar	funnelcompar
funnelperform	funnelperform
fuzzydid	fuzzydid
fvfix	fvfix
fview	fview
fvprevar	fvprevar
fvregen	fvregen
fvstrip	fvstrip
fvvar	fvvar
fwer1stage	nstagebinopt
fwtdgen	wtd
fxbcr	fxbcr
g2oz	cm2in
gamet	gamet
gamma4	gammafit
gammafit	gammafit
gammafit_lf	gammafit
gammafit_lf2	gammafit
gammareg_lf	fmm
gammasym	gammasym
gather	tidy
gausshermite	gausshermite
gb2fit	gb2fit
gb2fit_ll	gb2fit
gb2lfit	gb2lfit
gb2lfit_ll	gb2lfit
gb2pred	gb2fit
gb2reg	gb2reg
gbgfit	gbgfit
gbgfit_ll	gbgfit
gboxplot	gboxplot
gby	gby
gcause	gcause
gcause2	gcause
gciget	gciget
gcode	gcode
gcollapse	gtools
gconc	gconc
gcontract	gtools
gcrobustvar	gcrobustvar
gdecomp	gdecomp
gdistinct	gtools
gdsum	gdsum
gduplicates	gtools
ge_gravity	ge_gravity
geekel2d	geekel2d
gegen	gtools
geivars	geivars
gen_tail	gen_tail
genass	genass
gendist	ptvtools
gendummies	ptvtools
genefetch	efetch_tools
geneigen	geneigen
genfact	dcreate
genfreq	genfreq
gengap	mmsel
gengapp	mmsel
gengroup	gengroup
genhwcci	genhwcci
genicv	genicv
genidseq	genidseq
genif	lowyseattleb
geninteract	geninteract
genqreg	genqreg
genscore	genscore
genspec	genspec
gensplines	gensplines
genstack	genstack
genstacks	ptvtools
genstest	genstest
gentrun	gentrun
genvars	genvars
genyhats	ptvtools
geo2xy	geo2xy
geo2xy_lambert_sphere	geo2xy
geo2xy_run	geo2xy
geochart	geochart
geocircles	geocircles
geocircles_examples	geocircles
geocode	geocode
geocode_ip	geocode_ip
geocodehere	geocodehere
geocodeopen	geocodeopen
geodist	geodist
geodist2	geodist2
geodist_run	geodist
geoframe	geoplot
geoinpoly	geoinpoly
geoinpoly_examples	geoinpoly
geonear	geonear
geoplot	geoplot
geoquery	clipgeo
georoute	georoute
georoutei	georoute
getTimeSeries	getdata
get_train_test	r_ml_stata_cv
get_unit_time_effects	xtevent
getb	icalc
getbvarbmod	icalc
getcensus	getcensus
getdata	getdata
getdata_imf_alpha3	getdata
getdata_imf_num	getdata
getdatacodes	getdata
getdataconfig	getdata
getfilename2	getfilename2
getfvbase	icalc
getfvname	icalc
getgeneids	efetch_tools
getmstatistic	getmstatistic
getmxdata	getmxdata
getprime	getprime
getregstats	getregstats
gets	gets
getsymbols	getsymbols
getvallab	icalc
getvb	icalc
gevaluator	regmain
gevfit	gevfit
gevfit_lf2	gevfit
gfi	icalc
gformula	gformula
gformula_	gformula
ggeocode	jsonio
gglm	gtools
ggt	ggt
ggtax	ggtax
ggtaxonomy	ggtaxonomy
ghansen	ghansen
ghazal_guzzler	ghazal_guzzler
ghcloglog	ghsurv
ghistcum	ghistcum
ghk2version	ghk2
ghlogit	ghsurv
ghprobit	ghsurv
ghquadm	regoprob
ghsurv	ghsurv
ghsurv_p	ghsurv
ghsurv_set	ghsurv
ghxt	ghxt
giacross	forec_instab
gini	egen_inequal
ginicumul	ginireg
ginidesc	ginidesc
ginilma	ginireg
ginireg	ginireg
ginireg_estat	ginireg
ginireg_p	ginireg
gintreg	gintreg
gipf	gipf
gisid	gtools
git	git
gitee	gitee
giteedlg	gitee
giteeinstallmenu	gitee
givgauss2	givgauss2
givregress	gtools
glcurve	glcurve
glcurve5	glcurve5
glcurve7	glcurve7
glevelsof	gtools
glgamma2	glgamma2
gllam_ll	gllamm
gllamm	gllamm
gllapred	gllamm
gllarob	gllamm
gllas_yu	gllamm
gllasim	gllamm
glm_exp	qv
glmcorr	glmcorr
glmdeco	glmdeco
globel	lowyseattleb
glst	glst
gmap	gmap
gmci	gmci
gmean	egenmore
gmemultinomial	gmemultinomial
gmm_mqg	mqgamma
gmmcovearn	gmmcovearn
gmvport	mvport
gnbstrat	gnbstrat
gnpoisson	gnpoisson
go	fileutils
goelevation	goelevation
goll	gologit
gologit	gologit
gologit2	gologit2
gologit29	gologit29
gologit29_autofit	gologit29
gologit29_ll	gologit29
gologit29_p	gologit29
gologit2_autofit	gologit2
gologit2_lincom	gologit2
gologit2_ll	gologit2
gologit2_p	gologit2
gologit2_svy	gologit2
gologit2_svy_check	gologit2
gologit3_lf2	oparallel
googleplaces	googleplaces
goprobit	goprobit
goprobit_ll	goprobit
goprobit_p	goprobit
gpfobl	gpfobl
gphdt	ellip7
gphepssj	gphepssj
gphsave	ellip7
gphudak	gphudak
gpoisson	gtools
gprefscode	gprefscode
gpreg	gpreg
gpreset	gpreset
gpscore	doseresponse
gpscore2	gpscore2
gpscore_model	doseresponse
gquantiles	gtools
gradip	grcompare
grand	grand
grand2	grand2
graph3d	graph3d
graphbinary	graphbinary
graphexportpdf	graphexportpdf
graphlog	graphlog
graphlog_example	graphlog
graphlog_pdflatex_path	graphlog
graphlog_unix_setup	graphlog
graphms	multistate
graphquery	color_style
grby	grby
grcomb	grcomb
grdiame	grcompare
grdidip	grcompare
grdigap	grcompare
greg	gtools
gregress	gtools
grep	grep
greshape	gtools
grexport	grexport
grfreq	grfreq
gridsearch	gridsearch
grinset	grinset
grlogit	grlogit
grmarg	grcompare
grmatgroups	grmatgroups
grnote	grnote
grnotem	grnote
gropt	subsim_1
group1d	group1d
group2	egenmore
group2hdfe	group2hdfe
group3hdfe	group3hdfe
group_id	group_id
group_twoway	group_twoway
groupdata	groupcl
groupdist	groupdist
groupfunction	groupfunction
grouplabs	grouplabs
groups	groups
grpdf	grpdf
grpvars	grpvars
grqreg	grqreg
grsftest	grsftest
grstest	grstest
grstest2	grstest2
grstyle	grstyle
grstyle_set	grstyle
grtestsub	pcdid
grtext	grtext
grubbs	grubbs
grvar	grvar
gs2sls	gs2sls
gs2slsar	gs2slsar
gs2slsarxt	gs2slsarxt
gs2slsxt	gs2slsxt
gs3sls	gs3sls
gs3slsar	gs3slsar
gsa	gsa
gsa_binpu	gsa
gsa_pu	gsa
gsa_qoi	gsa
gsagraph	gsa
gsample	gsample
gsdata	gsdata
gsgroup	gsgroup
gsreg	gsreg
gstats	gtools
gsum	gsum
gsvy	gologit2
gtools	gtools
gtop	gtools
gtoplevelsof	gtools
gtsheckman	gtsheckman
gumbelfit	gumbelfit
gumbelfit_lf	gumbelfit
gunique	gtools
guttmanl	guttmanl
guttmax	loevh
gvselect	gvselect
gwhet	gwhet
gzappend	gzsave
gzipsave	gzipuse
gzipuse	gzipuse
gzmerge	gzsave
gzsave	gzsave
gzsaveold	gzsave
gzuse	gzsave
hadrilm	hadrilm
haif	haif
haifcomp	haif
haiku	haiku
half	egen_inequal
hallt	hallt-skewt
hamiltonfilter	hamiltonfilter
hammock	hammock
hammock_examples	hammock
hangr_beta	hangroot
hangr_chi2	hangroot
hangr_ci	hangroot
hangr_dagum	hangroot
hangr_exponential	hangroot
hangr_fisk	hangroot
hangr_gamma	hangroot
hangr_gb2	hangroot
hangr_geometric	hangroot
hangr_gev	hangroot
hangr_graph	hangroot
hangr_gumbel	hangroot
hangr_histgen	hangroot
hangr_histgensims	hangroot
hangr_invgamma	hangroot
hangr_laplace	hangroot
hangr_logistic	hangroot
hangr_lognormal	hangroot
hangr_nb1	hangroot
hangr_nb2	hangroot
hangr_normal	hangroot
hangr_pareto	hangroot
hangr_parsedist	hangroot
hangr_parseopts	hangroot
hangr_parsesample	hangroot
hangr_poisson	hangroot
hangr_sims	hangroot
hangr_sm	hangroot
hangr_theoretical	hangroot
hangr_uniform	hangroot
hangr_wald	hangroot
hangr_weibull	hangroot
hangr_zinb	hangroot
hangr_zip	hangroot
hangroot	hangroot
hangroot_ex	hangroot
hansen2	hansen2
hapblock	hapblock
hapipf	hapipf
hapupdate	hapipf
harmby	harmby
hashsort	gtools
hausman	hausman
haybittlepeto	groupseq
hazdcmp	hazdcmp
hbar	hbar
hbox	hbox
hcaccprox	hcaccprox
hcavar	hcavar
hcnbreg	hcnbreg
hdfe	hdfe
hdquantile	hdquantile
heabs	heabs
head	head
heapbs	heabs
heart	heart
heatmapgraph	heatmapgraph
heatplot	heatplot
heckman_fixedrho	fixedrho
heckman_fixedrho_lf	fixedrho
heckman_scanrho	fixedrho
heckp_d2	heckprob2
heckprob2	heckprob2
heckprobit_fixedrho	fixedrho
heckprobit_fixedrho_lf	fixedrho
heckprobit_scanrho	fixedrho
heckroc	heckroc
hegy4	hegy4
heterogi	heterogi
hetop	hetop
hetop_lf	hetop
hetpr_lf	hetprob
hetprob	hetprob
hetred	hetred
hetsar	hetsar
hetsar_p	hetsar
hettreatreg	hettreatreg
hexplot	heatplot
hextorgb	brewscheme
hful	hful_hlim
hgclg	hgclg
hglogit	hglogit
hhi	hhi
hhi5	hhi5
hibi	hibi
hildasetup	hildasetup
himap	himap
himatrix	himatrix
himod	decomp
hireg	hireg
hist3	hist3
histbox	histbox
historaj	historaj
histplot	histplot
hkar	hkar
hkstock	hkstock
hktrade	hktrade
hl	hl
hlTex	addtex
hlim	hful_hlim
hlist	hlist
hlm	hlm
hlm2	hlm
hlm3	hlm
hlmmkmdm2	hlm
hlmmkmdm3	hlm
hlmrun	hlm
hlmstore	hlm
hlmtest	hlm
hlp2html	hlp2html
hlp2pdf	hlp2pdf
hlp2winpdf	hlp2winpdf
hlpdir	hlpdir
hlpedit	hlpedit
hmap	hmap
hmean	egenmore
hmindex	hmindex
hmm	egenmore
hmmss	egenmore
hms	egenmore
hnbclg	hnbclg
hnblogit	hnblogit
hnbreg1	hnbreg1
hodgesl	hodgesl
hoi	hoi
hoishapley	hoishapley
holdingrets	mvport
holrein	mkdat
holsti	holsti
homogeni	midas
honestdid	honestdid
honestwork	honestdid
hotdeck	hotdeck
hotdeck6	hotdeck
hotdeckvar	hotdeckvar
hotvalue	hotvalue
how_many_imputations	how_many_imputations
hpc	hpc
hpclg	hpclg
hpfilter	hpfilter
hplogit	hplogit
hplot	hplot
hprescott	hprescott
hprescott8	hprescott
hrimvol	hrimvol
hs	lowyseattleb
hshaz	hshaz
hshaz_ll	hshaz
hsmode	hsmode
hte	hte
htm	lowyseattlea
html	weaver
htmlcb	htmlcb
htmlclose	htmlutil
htmlimg	htmlutil
htmllink	htmlutil
htmlopen	htmlutil
htmltab2stata	htmltab2stata
htmltit	htmltit
hue	hue
hummels	hummels
hutchens	hutchens
hvar	rif
hyphens	probitiv
i0kappa	circular
i1kappa	circularkde
i2kappa	circularkde
iati	iati
ic	ic
icc23	icc23
iccconf	iccconf
iccvar	iccvar
icd9tmpm	icdpic
icdpic	icdpic
ice	ice
ice_	ice
ice_reformat	ice
icet	icet
ici	ic
icio	icio
icio_clean	icio
icio_load	icio
iciss	icdpic
icomp	icomp
icp	ic
icw_index	icw_index
idonepsu	idonepsu
ie_norm	ie_rate
ie_rate	ie_rate
ie_reg	ie_rate
iebaltab	ietoolkit
ieboilsave	ietoolkit
ieboilstart	ietoolkit
iecodebook	iefieldkit
iecompdup	iefieldkit
iecorrect	iefieldkit
ieddtab	ietoolkit
iedorep	ietoolkit
iedropone	ietoolkit
ieduplicates	iefieldkit
iefieldkit	iefieldkit
iefolder	ietoolkit
iefonts	inclusion_economics_scheme
iegitaddmd	ietoolkit
iegraph	ietoolkit
iekdensity	ietoolkit
iematch	ietoolkit
iesave	ietoolkit
ietestform	iefieldkit
ietoolkit	ietoolkit
iexp_xtr	wtd
iexptl	wtd
ifin	ifin
ifirst	egenmore
ifwins	ifwins
igeintb	igeintb
igencox	igencox
igencox_p	igencox
igenerate	igenerate
igeset	igeset
igesetci	igesetci
igini	igini
igini1	igini1
ihelp	ihelp
ihstrans	ihstrans
iia	iia
iimpute	ptvtools
ikbw	rdexo
ilast	egenmore
illdprep	stpm2illd
ilses	iscoil
imb	cem
imbalance	imbalance
imc_int	wtd
imc_tail	wtd
img	weaver
imperfectiv	imperfectiv
import_svmlight	svmachines
importlabels	lowyseattleb
importsav	importsav
imputeitems	imputeitems
imputemok	imputemok
imputerasch	imputerasch
imq0sub	subsim_1
imqsub	subsim_1
imqsub_cob_doug	subsim_1
imrsub	subsim_1
imsref	subsim_1
imusic	imusic
imvol	imvol
imwegsub	subsim_1
imwsub	subsim_1
imwsub_cob_doug	subsim_1
inccat	inccat
incomecdf	ceq
incss	egenmore
incsub	subsim_1
indep4asm	dep4asm
indeplist	indeplist
index	index
indexplot	modeldiag
indexplot7	modeldiag
ineq	ineq
ineqdec0	ineqdec0
ineqdec05	ineqdec0
ineqdecgini	ineqdecgini
ineqdeco	ineqdeco
ineqdeco5	ineqdeco
ineqfac	ineqfac
ineqord	ineqord
ineqrbd	ineqrbd
inequal	egen_inequal
inequal2	inequal2
inequal7	inequal7
inflate	inflate
influence_barchart	boost
influence_delete	boost
ingap	ingap
inlist2	inlist2
innerregife	regife
innerwedge	groupseq
inorm	inorm
inormpi	inorm
inputst	stcmd
insertat	lowyseattleb
insheetjson	insheetjson
inshell	inshell
inshell_detect_pwsh	inshell
inshell_diagnostics	inshell
inshell_get_pwsh_vers	inshell
inshell_getshell	inshell
insingap	insingap
inslist	listutil
insob	insob
installpkg	installpkg
installpkgdlg	installpkg
installpkgmenu	installpkg
intcens	intcens
intcens_ll	intcens
inteff3	inteff3
integrate	integrate
integrate_aq	integrate_aq
interactplot	interactplot
intercorr	lowyseattleb
interflex	interflex
intext	intext
intgph	intgph
intllf_gb2exp	gintreg
intllf_gb2exp_group	gintreg
intllf_ggsigma	gintreg
intllf_ggsigma_group	gintreg
intllf_lnormal	gintreg
intllf_lnormal_group	gintreg
intllf_normal	gintreg
intllf_normal_group	gintreg
intllf_sged	gintreg
intllf_sged_group	gintreg
intllf_sgt_condition	gintreg
intllf_sgt_condition_group	gintreg
intspec	icalc
intterms	intterms
invcdf	invcdf
invcise	invcise
invdesc	invdesc
invgammafit	invgammafit
invgammafit_lf	invgammafit
invgausscf	invgaussfit
invgaussfit	invgaussfit
invgaussfit_lf	invgaussfit
invmvnormal	mvtnorm
invmvt	mvtnorm
invtmvnormal	mvtnorm
invtmvt	mvtnorm
invvm	circular
iop	iop
iot	iot
ipabcstats	ipabcstats
ipdfc	ipdfc
ipdforest	ipdforest
ipdmetan	ipdmetan
ipdover	ipdmetan
ipdpower	ipdpower
ipf	ipf
ipfraking	ipfraking
ipfraking_report	ipfraking
ipfweight	ipfweight
ipshin	ipshin
ipwbreg	ipwbreg
ipwlogit	ipwlogit
iquantile	iquantile
ira	ira
irax	irax
irr	irr
irrepro	irrepro
irrepron	irrepro
irscharities	irscharities
isa	isa
isa_1st_loop	isa
isa_2nd_loop	isa
isa_est	isa
isa_est_woinit	isa
isa_graph	isa
isa_loop	isa
isa_mle	isa
isa_rangecheck	isa
isa_rsq_outcome	isa
isa_rsq_treat	isa
isa_search	isa
isa_xplots	isa
isco08isei	iscoil
isco6888	isco
iscoegp	isco
iscogen	iscogen
iscoil	iscoil
iscoisei	isco
iscolab	isco
iscolbl	iscogen
iscooesch	oesch
iscotrei	isco
isis	posw_posis
isko8868	isko
iskoegp	isko
iskoisei	isko
iskolab	isko
iskooesch	oesch
iskotrei	isko
iso3166	egenmore
isoboot	isograph
isograph	isograph
isopoverty	isopoverty
isprime	getprime
isprimeversion	getprime
istdize	istdize
isvar	isvar
itercenter	regxfe
itmeus	itmeus
itpscore	itpscore
itsa	itsa
itsamatch	itsamatch
itsaperm	itsaperm
itsarand	itsarand
itsp_ado	itsp_ado
itspower	itspower
itvalpctile	itvalpctile
iv_poisson	ivpois
ivactest	ivactest
ivbounds	ivbounds
ivcheck	ivcheck
ivcrc	ivcrc
ivdesc	ivdesc
ivdesc_calc	ivdesc
ivendog	ivendog
ivgauss2	ivgauss2
ivgln_ll	ivgauss2
ivglog	ivglog
ivgmm0	ivgmm0
ivgravity	ivgravity
ivhettest	ivhettest
ivlasso	pdslasso
ivlasso_p	pdslasso
ivolsdec	ivolsdec
ivpermute	ivpermute
ivpois	ivpois
ivprob	ivprob-ivtobit6
ivqreg2	ivqreg2
ivreg2	ivreg2
ivreg210	ivreg210
ivreg210_p	ivreg2
ivreg28	ivreg28
ivreg28_cue	ivreg2
ivreg28_p	ivreg2
ivreg29	ivreg29
ivreg29_cue	ivreg29
ivreg29_p	ivreg29
ivreg2_p	ivreg2
ivreg2h	ivreg2h
ivreg2hdfe	ivreg2hdfe
ivreg2m	ivreg2m
ivreg_ss	ivreg_ss
ivreghdfe	ivreghdfe
ivregress2	ivregress2
ivreset	ivreset
ivtobit	ivprob-ivtobit
ivtobit6	ivprob-ivtobit6
ivtreatreg	ivtreatreg
ivvif	ivvif
jaccard	jaccard
jarowinkler	jarowinkler
jb	jb
jb6	jb6
jc	jc
jcd	jc
jcnb_ll	cnbreg
jformat	jformat
jhgeo_cln_ll	hgclg
jhgeo_logit_ll	hglogit
jhhnb1_ll	hnbreg1
jhnb_cln_ll	hnbclg
jhnb_logit_ll	hnblogit
jhnbstr_ll	nbstrat
jhpoi_cln_ll	hpclg
jhpoi_ll	gnpoisson
jhpoi_logit_ll	hplogit
jhzgeo_ll	ztg
jmpierce	jmpierce
jmpierce2	jmpierce2
jnsn	jnsn
jnsni	jnsn
jnsw	jnsn
johans	johans
join	ftools
joinlist	listutil
joinvars	joinvars
jonter	jonter
joy_plot	joy_plot
joyplot	joyplot
jrule	jrule
jsonio	jsonio
jwdid	jwdid
jwdid_estat	jwdid
jwdid_plot	jwdid
k_capc	kountry
k_cowc	kountry
k_cown	kountry
k_geo_cow	kountry
k_geo_marc	kountry
k_geo_meb	kountry
k_geo_men	kountry
k_geo_sov	kountry
k_geo_un	kountry
k_geo_undet	kountry
k_imfn	kountry
k_iso2c	kountry
k_iso3c	kountry
k_iso3n	kountry
k_marc	kountry
k_mcc	kountry
k_other	kountry
k_penn	kountry
k_stuck	kountry
k_unc	kountry
ka	krippalpha
kakwani	egen_inequal
kalpha	kalpha
kanom	kanom
kapgof	kapgof
kaplansky	kaplansky
kappa2	kappa2
kappaAux	kappa2
kappaci	kaputil
kappaetc	kappaetc
kappaetci	kappaetc
kappaetcssi	kappaetc
kappci	kaputil
kapprevi	kapprevi
kapssi	kaputil
katego	katego
kconst	rdmse
kdbox	kdbox
kdens	kdens
kdens2	kdens2
kdmany	kdmany
keeporder	keeporder
keepvar	keepvar
kernel	kernel
kernreg1	kernreg1
kernreg2	kernreg2
keyby	keyby
keybygen	keyby
keyplot	keyplot
kfoldclass	kfoldclass
khb	khb
khbtab	khb
kinkyreg	kinkyreg
kinkyreg2dta	kinkyreg
kinkyreg_estat	kinkyreg
kinkyreg_p	kinkyreg
kitchensink	kitchensink
kitli_compare2bm	kit_livingincome
kitli_gap2bm	kit_livingincome
kmatch	kmatch
kmatch_svyr	kmatch
kmest	kmest
kmest_p	kmest
knapsack	knapsack
kobo2stata	kobo2stata
konfound	konfound
kotlarski	kotlarski
kountry	kountry
kountryadd	kountry
kountrybackup	kountry
kountryrestore	kountry
kpss	kpss
kr20	kr20
krippalpha	krippalpha
krls	krls
krls_p	krls
ksi	ksi
ksmirnov2var	ksmirnov2var
kssur	kssur
ksur	ksur
kurtosisreg	skewreg
kwallis2	kwallis2
kweight	vc_pack
kwstat	kwstat
ky_estat	ky_fit
ky_fit	ky_fit
ky_ll_1	ky_fit
ky_ll_2	ky_fit
ky_ll_3	ky_fit
ky_ll_4	ky_fit
ky_ll_5	ky_fit
ky_ll_6	ky_fit
ky_ll_7	ky_fit
ky_ll_8	ky_fit
ky_p	ky_fit
ky_sim	ky_fit
ky_star	ky_fit
lab2varn	labutil2
labascii	labutil2
labbe	metan
labcd	labutil
labcenswdi	labcenswdi
labcopy	labutil
labcpy	labutil2
labdel	labutil
labdeval	labutil2
labdtch	labutil
labdu	labutil2
labeldatasyntax	labeldatasyntax
labellacking	labellacking
labellist	labellist
labelmiss	labelmiss
labelsof	labelsof
labgen	labgen
labgen2	labutil2
lablist	lablist
lablog	labutil
labmap	labutil
labmask	labutil
labmatch	labmatch
labmm	labmm
labmv	labmv
labmvs	labutil2
labmvs9	labutil2
labnoeq	labutil
labone	labone
labrec	labrec
labrecode	labutil2
labren	labutil2
labreplace	labgen
labsort	labsort
labsumm	labsumm
labunab	labutil2
labundef	labundef
labup	labup
labvalch	labutil
labvalch3	labvalch3
labvalcl	labvalcl
labvalclone	labutil
labvalcombine	labutil
labvalpool	labvalpool
labvarch	labutil
labvars	labvars
lado	dirtools
lall	dirtools
lambda	lambda
landemets	landemets
lany	lany
laplacereg	laplacereg
lars	lars
lasagna	lasagna
lasso2	lassopack
lasso2_p	lassopack
lassologit	lassopack
lassologit_p	lassopack
lassoregress	elasticregress
lassoutils	lassopack
lastnm	egenmore
lastupto	lastupto
latab	latab
latabstat	latab
late_estim_X	fuzzydid
late_estim_noX	fuzzydid
lboot	isograph
lbpower	lbpower
lbsvmat	lbsvmat
lcaentropy	lcaentropy
lclist	listutil
lclogit	lclogit
lclogit2	lclogit2
lclogitcov	lclogit
lclogitcov2	lclogit2
lclogitml	lclogit
lclogitml2	lclogit2
lclogitpr	lclogit
lclogitpr2	lclogit2
lclogitwtp2	lclogit2
lcmc	lcmc
lcmc_ll	lcmc
lcmc_predict	lcmc
ldecomp	ldecomp
ldir	dirtools
ldo	dirtools
ldta	dirtools
ldtest	ldtest
ldtestmp	ldtest
leanout	leanout
leebounds	leebounds
leedtwoway	leedtwoway
leftalign	leftalign
legendrisation	fuzzydid
leps	dirtools
levels	levels
levels7	levels
levene	levene
levenshtein	strgroup
levinlin	levinlin
levpredict	levpredict
lfdes	lfsum
lfk	lfk
lfsum	lfsum
lfsummvl	lfsum
lftabl	lfsum
lfuni	lfsum
lgamm_ll	glgamma2
lgamma2	lgamma2
lgph	dirtools
lgraph	lgraph
lgroup	tabplot
lianxh	lianxh
libbrewscheme	brewscheme
libd3	libd3
libhtml	libhtml
lincheck	lincheck
lincom2	lincom2
lincomest	lincomest
lincomest_p	lincomest
linepalette	palettes
linequate	linequate
linkplot	linkplot
lint	stata_linter
lintrend	lintrend
linuxlsd1	linuxlsd1
lisrelinput	lisrelinput
listfirst	listfirst
listmiss	listmiss
listsome	listsome
listtab	listtab
listtab_rstyle	listtab
listtab_vars	listtab
listtex	listtex
listtex_rstyle	listtex
listtex_vars	listtex
listwise	cem
ljs	ljs
ljust	cart
llf_gb2	gb2reg
llf_gg	gb2reg
llf_ln	gb2reg
lli	runmplus
llinuxlsd1	linuxlsd1
lmabg	lmabg
lmabg2	lmabg2
lmabgnl	lmabgnl
lmabgxt	lmabgxt
lmabp	lmabp
lmabp2	lmabp2
lmabpg	lmabpg
lmabpg2	lmabpg2
lmabpgnl	lmabpgnl
lmabpgxt	lmabpgxt
lmabpnl	lmabpnl
lmabpxt	lmabpxt
lmabxt	lmabxt
lmadurh	lmadurh
lmadurh2	lmadurh2
lmadurhxt	lmadurhxt
lmadurm	lmadurm
lmadurm2	lmadurm2
lmadurmnl	lmadurmnl
lmadurmxt	lmadurmxt
lmadw	lmadw
lmadw2	lmadw2
lmadwnl	lmadwnl
lmadwxt	lmadwxt
lmalb	lmalb
lmalb2	lmalb2
lmalbnl	lmalbnl
lmanlsur	lmanlsur
lmareg3	lmareg3
lmasem	lmasem
lmata	dirtools
lmavon	lmavon
lmavon2	lmavon2
lmavonnl	lmavonnl
lmavonxt	lmavonxt
lmawxt	lmawxt
lmaz	lmaz
lmaznl	lmaznl
lmcol	lmcol
lmcovnlsur	lmcovnlsur
lmcovreg3	lmcovreg3
lmcovsem	lmcovsem
lmcovvar	lmcovvar
lmcovxt	lmcovxt
lmdi	lmdi
lmeg	lmeg
lmfreg	lmfreg
lmfreg2	lmfreg2
lmgc	lmgc
lmharch	lmharch
lmharch2	lmharch2
lmharchnl	lmharchnl
lmharchxt	lmharchxt
lmhcw	lmhcw
lmhcw2	lmhcw2
lmhcwnl	lmhcwnl
lmhcwxt	lmhcwxt
lmhgl	lmhgl
lmhgl2	lmhgl2
lmhglnl	lmhglnl
lmhharv	lmhharv
lmhharv2	lmhharv2
lmhhp	lmhhp
lmhhp2	lmhhp2
lmhhpnl	lmhhpnl
lmhhpxt	lmhhpxt
lmhlmxt	lmhlmxt
lmhlrxt	lmhlrxt
lmhmss2	lmhmss2
lmhnlsur	lmhnlsur
lmhreg3	lmhreg3
lmhsem	lmhsem
lmhwald	lmhwald
lmhwaldxt	lmhwaldxt
lmnad	lmnad
lmnad2	lmnad2
lmnadnl	lmnadnl
lmnadxt	lmnadxt
lmndh	lmndh
lmndp	lmndp
lmndp2	lmndp2
lmngr	lmngr
lmngry	lmngry
lmngry2	lmngry2
lmngryxt	lmngryxt
lmnjb	lmnjb
lmnjbnl	lmnjbnl
lmnnlsur	lmnnlsur
lmnreg3	lmnreg3
lmnsem	lmnsem
lmnwhite	lmnwhite
lmnwhite2	lmnwhite2
lmnwhitenl	lmnwhitenl
lmnwhitext	lmnwhitext
lmoments	lmoments
lmoments6	lmoments
lmoments8	lmoments
lmoments9	lmoments
lmose	lmoments
lms	lms
lmsdirb	msdirb
lmsrd	lmsrd
lmtest	lmtest
lmztest	lmztest
lnmor	lnmor
loadratetable	stns
loasampsi	loasampsi
local_inlist	ftools
localp	localp
localseg	segregation
locpoly3	mtefe
locpr	locpr
locproj	locproj
loevh	loevh
log2do2	log2do2
log2html	log2html
log2html7	log2html
log2markup	log2markup
logaxis	regaxis
logitasinh	cdfquantreg
logitburr7	cdfquantreg
logitburr8	cdfquantreg
logitcauchy	cdfquantreg
logitcprplot	logitcprplot
logitfe	logitfe
logithetm	logithetm
logithetm_lf	logithetm
logitlogistic	cdfquantreg
logitrank	abg
logitt2	cdfquantreg
logittorisk	logittorisk
logittoriski	logittorisk
loglogistic_leftcensor	giniinc
loglogistic_lefttrunc	giniinc
lognfit	lognfit
lognfit_ll	lognfit
lognormal_leftcensor	giniinc
lognormal_lefttrunc	giniinc
lognormalreg_lf	fmm
lognpred	lognfit
logout	logout
logpred	logpred
logtest	logtest
lomackinlay	lomackinlay
lomod	decomp
lomodrs	lomodrs
longch	longch
longplot	longplot
longshape	longshape
looclass	looclass
loocv	loocv
lookfor2	lookfor2
lookfor_all	lookfor_all
lookfor_val	lookfor_val
lookforit	lookforit
loopplot	loopplot
lorenz	lorenz
lorobwei	adjksm
louvain	louvain
louvain_gcd	luvain
lowyupdate	lowyseattle
lpbwdensity	lpdensity
lpdensity	lpdensity
lpdf	dirtools
lppinv	lppinv
lpr4ytz	persuasio
lprplot	lprplot
lqte_estim_noX	fuzzydid
lrchg	lrchg
lrdrop1	lrdrop1
lrjtest	johans
lrmat	midas
lrmatx	lrmatx
lrplot	lrplot
lrseq	lrseq
lsacsetup	lsacsetup
lsmcl	dirtools
lstack	lstack
lstrfun	lstrfun
ltable2	ltable2
ltex	dirtools
ltop	ltop
lvalues	lvalues
lvr2plot2	lvr2plot2
lxhuse	lxhuse
lxpct_2	lxpct_2
maanova	meta_analysis
mac_unab	mac_unab
macrof	macrof
madfuller	madfuller
madot	madot
mads	mads
maforest	meta_analysis
mahapick	mahapick
mahascore	mahapick
mahascore2	mahapick
mahascores	mahapick
mahaselectunique	mahapick
mail	mail
majority	majority
make2	installpkg
makeddi	makeddi
makediagram	diagram
makehlp	makehlp
makeid	makeid
makematrix	makematrix
maketex	maketex
maketrpr	sadi
malmq2	malmq2
manski_ci	manski_ci
map	map
mapch	mapch
maplist	listutil
maptile	maptile
maptile_geohelp	maptile
maptile_geolist	maptile
maptile_install	maptile
mareg	meta_analysis
marg_betacumul_prep	margdistfit
marg_betahangroot_prep	margdistfit
marg_betapp_prep	margdistfit
marg_betaqq_prep	margdistfit
marg_nb1cumul_prep	margdistfit
marg_nb1hangroot_prep	margdistfit
marg_nb1pp_prep	margdistfit
marg_nb1qq_prep	margdistfit
marg_nb2cumul_prep	margdistfit
marg_nb2hangroot_prep	margdistfit
marg_nb2pp_prep	margdistfit
marg_nb2qq_prep	margdistfit
marg_normcumul_prep	margdistfit
marg_normhangroot_prep	margdistfit
marg_normpp_prep	margdistfit
marg_normqq_prep	margdistfit
marg_parsamp	margdistfit
marg_poissoncumul_prep	margdistfit
marg_poissonhangroot_prep	margdistfit
marg_poissonpp_prep	margdistfit
marg_poissonqq_prep	margdistfit
marg_zinbcumul_prep	margdistfit
marg_zinbhangroot_prep	margdistfit
marg_zinbpp_prep	margdistfit
marg_zinbqq_prep	margdistfit
marg_zipcumul_prep	margdistfit
marg_ziphangroot_prep	margdistfit
marg_zippp_prep	margdistfit
marg_zipqq_prep	margdistfit
margdistfit	margdistfit
margdistfit_ex	margdistfit
margeff	margeff
margeff8	margeff
margin	margin
margin6	margin
margin_e	margin
marginscontplot2	marginscontplot2
margintegrate	margintegrate
marglmean	marglmean
marglmean_p	marglmean
margprev	margprev
margprev_p	margprev
marhis	marhis
marimekko	marimekko
mark_changes	mark_changes
marker	marker
markov	markov
markstat	markstat
marktop	matrixtools
marktouse	marktouse
markupest	markupest
masum	meta_analysis
mat2do	ipfraking
mat2txt	mat2txt
mat2xl	matrixtools
matamatrix	matamatrix
matcfa	matodd
matcfm	matodd
matchit	matchit
matchk	matodd
matcname	matodd
matcsort	matvsort
matdelrc	matodd
matewd	matodd
matewm	matodd
matewop	matodd
matgop	matodd
matin4	matin4-matout4
matload	matsave
matmad	matodd
matmap	matmap
matmps	matodd
matnames	matnames
matout4	matin4-matout4
matpow	matodd
matprint	matrixtools
matpwcorr	matpwcorr
matrix2stata	matrixtools
matrixof	matrixof
matrsort	matvsort
matsave	matsave
matsort	matsort
matsusort	matvsort
matvsort	matvsort
matvsort6	matvsort
matwrite	matwrite
mauchly	mauchly
maxdrawdown	maxdrawdown
maxindcorr	itsp_ado
mbitobit	mbitobit
mbitobit_lf	mbitobit
mbitobit_p	mbitobit
mbsens	mbsens
mc	mc
mca	mca
mcd	mm_regress
mcenter	mcenter
mces	mces
mcib	mcib
mclest	mcl
mclgen	mcl
mcmcconverge	mcmcstats
mcmccqreg	mcmccqreg
mcmcmixed	mcmclinear
mcmcreg	mcmclinear
mcmcsum	runmlwin
mcmcsummarize	mcmcstats
mcp2	marginscontplot2
mcq2long	mcqscore
mcq_lik	mcqscore
mcqscore	mcqscore
mcsimul	itsp_ado
mcwr	mcwr
md2ddi2_5	dta2md
mdensity	mdensity
mdepriv	mdepriv
mdesc	mdesc
mean2	mean2
meaning	meaning
meanrets	mvport
meanvar	itsp_ado
medcouple	medcouple
medeff	mediation
median	median
medoid	medoid
medsem	medsem
medsens	mediation
medsurv	medsurv
mehetprob	mehetprob
mehran	egen_inequal
meloreg2	meloreg2
melt	melt
meoprobit	meoprobit
mequate	mequate
meresc	meresc
mergeall	mergeall
mergegz	gziputil
mergemany	mergemany
mergepoly	mergepoly
mergevirtual	difwithpar
merlin	merlin
merlin_p	merlin
merlin_parse	merlin
mest	mtab
meta	metatrim
meta_lr	meta_lr
metaan	metaan
metaan_reml	metaan
metabias	metabias
metabias6	metabias
metacum	metacum
metacum_examples	metacum
metadata	metadata
metadta	metadta
metadta_examples	metadta
metaeff	metaeff
metafrag	metafrag
metafunnel	metafunnel
metagen	metagen
metagraph	metagraph
metamiss	metamiss
metamiss2	metamiss2
metamiss2_corr_example	metamiss2
metan	metan
metan7	metan
metan9	metan
metan_analysis	metan
metan_examples	metan
metan_hlp_run	metan
metan_output	metan
metan_pooling	metan
metandi	metandi
metandi_p	metandi
metandiplot	metandi
metani	metan
metaninf	metaninf
metannt	metan
metaparm	metaparm
metapow	metapow
metapow_eg1	metapow
metapow_ploteg1	metapow
metapowplot	metapow
metapred	metapred
metapreg	metapreg
metapreg_examples	metapreg
metaprop	metaprop
metaprop_Examples	metaprop
metaprop_one	metaprop_one
metaprop_one_examples	metaprop_one
metareg	metareg
metareg_ll	metareg
metareg_p	metareg
metareg_pm	metareg
metasim	metapow
metastrong	metastrong
metastrong_nonpar	metastrong
metatef	metatef
metatrend	metatrend
metatrim	metatrim
metricp	sadi
mexcel	mtab
mfelogit	mfelogit
mfilegr	mfilegr
mfpi	mfpi
mfpi_plot	mfpi
mfpigen	mfpigen
mfpmi	mfpmi
mfpmi_10	mfpmi
mfpmi_wald	mfpmi
mfpmi_wald_10	mfpmi
mfx2	mfx2
mfxrcspline	postrcspline
mfxrcspline_ex	postrcspline
mgbe	mgbe
mgbe_cdf	mgbe
mgbe_ll	mgbe
mgen	mgen
mgf_unbal	xtprobitunbal
mgof	mgof
mgofi	mgof
mgus_example	stexpect
mhl	mhl
mhplot	metaninf
mhtexp	mhtexp
mhtreg	mhtreg
mi_cmd_mvncat	mi_mvncat
mi_impute_cmd_wlogit	mi_impute_wlogit
mi_impute_cmd_wlogit_init	mi_impute_wlogit
mi_impute_cmd_wlogit_parse	mi_impute_wlogit
mi_impute_cmd_wlogit_return	mi_impute_wlogit
mi_impute_cmd_wmlogit	mi_impute_wlogit
mi_impute_cmd_wmlogit_init	mi_impute_wlogit
mi_impute_cmd_wmlogit_parse	mi_impute_wlogit
mi_impute_cmd_wmlogit_return	mi_impute_wlogit
mi_twoway	mi_twoway
miappend	mitools
mibmi	mibmi
mici	mitools
micombine	ice
mict_impute	mict
mict_model_gap	mict
mict_model_initial	mict
mict_model_terminal	mict
mict_prep	mict
midas	midas
mido	mitools
miesize	miesize
mif2dta	mif2dta
mifit	mitools
miinc	miinc
mijoin	ice
milincom	mitools
mim	mim
mimerge	mitools
mimic_e2	propcnsreg
mimic_lf	propcnsreg
mimix	mimix
mimpt	mimpt
mimrgns	mimrgns
mimrgns_estimate	mimrgns
mimstack	mimstack
mimstepwise	mim
min_cv_mkern	mkern
minap	minap
minmse	minmse
mint	mint
minutes	egenmore
mipllest	miparallel
mipolate	mipolate
mira	mira
mireset	mitools
mirubin	miparallel
misave	mitools
miset	mitools
misplit	ice
missing	missing
missingplot	missingplot
missings	missings
misspattern	network
misum	misum
mitestparm	mitools
mivbon	mivcausal
mivcausal	mivcausal
mivchecks	mivcausal
mivcs	mivcausal
mivif	mivif
miviut	mivcausal
mivmint	mivcausal
mivreg	mivcausal
mivrsw	mivcausal
mivvars	mivcausal
mixdom	domin
mixlbeta	mixlogit
mixlcov	mixlogit
mixlog_d1	mixlogit
mixlogit	mixlogit
mixlogitwtp	mixlogitwtp
mixlpred	mixlogit
mixmcm	mixmcm
mixmixlogit	mixmixlogit
mixmixlogit_d1	mixmixlogit
mixnorm	egenmore
mizrachl2	mizrachl2
mk_xtab_m2	subsim_1
mkbilogn	mkbilogn
mkcorr	mkcorr
mkdashsn	mkstrsn
mkdat	mkdat
mkdensity	mkdensity
mkern	mkern
mkest	mkest
mkfrac	fodstr
mkheader	plssem
mkmargvar	icalc
mkname1	stbtcalc
mkomega	ntreatreg
mkonfound	konfound
mkprofile	mkprofile
mkproject	mkproject
mkspline2	postrcspline
mkstrsn	mkstrsn
mktab	mktab
mktable	plssem
mktable_corr	plssem
mktable_indirect	plssem
mktable_mediate	plssem
ml_spike	spike
mlabvpos	egenmore
mlad	mlad
mlad_ll	mlad
mlboolean	mlboolean
mlboolfirst	mlboolean
mlboollog	mlboolean
mlboolpred	mlboolean
mlboolprep	mlboolean
mlboolprob	mlboolean
mlcoint	mlcoint
mld	egen_inequal
mlogitroc	mlogitroc
mlogpred	mlogpred
mlowess	mlowess
mlr2sls	mlr2sls
mlsurvlf	stpm
mlt2stage	mlt
mltcooksd	mlt
mltl2scatter	mlt
mltrsq	mlt
mltshowm	mlt
mlwtd_exp	wtd_perc
mlwtd_lnorm	wtd_perc
mlwtd_wei	wtd_perc
mlwtdttt_exp	wtdttt
mlwtdttt_lnorm	wtdttt
mlwtdttt_wei	wtdttt
mm_dripw	drdid
mm_regipw	drdid
mm_repeated	drdid
mmat	mtab
mmat2tex	mmat2tex
mmeiv	mmeiv
mmerge	mmerge
mmodes	mmodes
mmqreg	mmqreg
mmregress	mm_regress
mmsel	mmsel
mmsrm	mmsrm
mmws	mmws
mnthlist	listutil
mnthplot	mnthplot
mobs	mtab
mod11	mod11
mod11i	mod11
models	lowyseattleb
modlpr	modlpr
mog	mog
mol	mol
moments	moments
moments2	moments2
monotone_mean	wald_mse
moranplot	moranplot
moransi	moransi
moreobs	moreobs
moss	moss
motivate	motivate
motivatedolly	motivatedolly
movavg	movavg
movestay	movestay
movestay_d2	movestay
movestay_p	movestay
mpi	mpi
mpitb	mpitb
mplotoffset	mplotoffset
mpovline	mpovline
mpr	mpr
mqgamma	mqgamma
mqgamma_p	mqgamma
mrdum	mrdum
mregress	mm_regress
mrgraph	mrtab
mrobust	mrobust
mrprjlik	mrprobit
mrprlik	mrprobit
mrprobit	mrprobit
mrsprep	mrsprep
mrsprep_example	mrsprep
mrtab	mrtab
ms_add_comma	ftools
ms_compile_mata	ftools
ms_expand_varlist	ftools
ms_fvstrip	ftools
ms_fvunab	ftools
ms_get_version	ftools
ms_parse_absvars	ftools
ms_parse_varlist	ftools
ms_parse_vce	ftools
msaj	multistate
msboxes	multistate
msboxes_examples	multistate
mscatter	mscatter
msdeco	msdeco
msdecode	sdecode
msdirb	msdirb
msdthaz	dthaz
mseffect	mseffect
msp	msp
msplot	msplot
msq2ftsq	cm2in
msregress	mm_regress
mss	mss
msset	multistate
mstat	m_stats
mstbayes	eefanalytics
mstdize	mstdize
mstdize6	mstdize
mstdizem	matodd
mstfreq	eefanalytics
mstore	mstore
msub	egenmore
msum	mtab
mtab1	mtab
mtab2	mtab
mtad	mtad
mtebinary	mtebinary
mtefe	mtefe
mtefe_gendata	mtefe
mtefe_movestay_lf2	mtefe
mtefe_secondstage	mtefe
mtefeplot	mtefe
mtemore	mtemore
mtest	m_stats
mtpi	mtpi
mtreatreg	mtreatreg
mtreatreg_gamma_lf	mtreatreg
mtreatreg_gamma_p	mtreatreg
mtreatreg_logit_lf	mtreatreg
mtreatreg_logit_p	mtreatreg
mtreatreg_mmlogit_lf	mtreatreg
mtreatreg_negbin1_lf	mtreatreg
mtreatreg_negbin1_p	mtreatreg
mtreatreg_negbin2_lf	mtreatreg
mtreatreg_negbin2_p	mtreatreg
mtreatreg_normal_lf	mtreatreg
mtreatreg_normal_p	mtreatreg
mulogit	mulogit
multencode	multencode
multibar	multibar
multicoefplot	multicoefplot
multidensity	multidensity
multidot	multidot
multif	multif
multiline	multiline
multimport	multimport
multin	groupcl
multin2_ll	groupcl
multin_ll	groupcl
multipurt	multipurt
multishell	multishell
multivrs	multivrs
multivrs_calc_summary_stats	multivrs
multivrs_dependencies	multivrs
multivrs_display_results	multivrs
multivrs_estimate	multivrs
multivrs_marginsplot	multivrs
multivrs_parse_est_options	multivrs
multivrs_parse_models	multivrs
multivrs_parse_multivrs_options	multivrs
multivrs_parse_varlist	multivrs
multivrs_plot	multivrs
multproc	smileplot
mundlak	mundlak
muxplot	muxplot
muxyplot	muxyplot
mvcorr	mvcorr
mvdcmp	mvdcmp
mvdcmpgroup	mvdcmp
mvdom	domin
mvfiles	mvfiles
mvis	mice
mvmeta	mvmeta
mvmeta_bscov_correlation	mvmeta
mvmeta_bscov_equals	mvmeta
mvmeta_bscov_exchangeable	mvmeta
mvmeta_bscov_proportional	mvmeta
mvmeta_bscov_unstructured	mvmeta
mvmeta_lmata	mvmeta
mvmeta_make	mvmeta
mvmeta_mufromsigma	mvmeta
mvnormalden	mvtnorm
mvport	mvport
mvppred	mvprobit
mvprob_ll	mvprobit
mvprobit	mvprobit
mvsamp1i	mvsamp1i
mvsampsi	mvsampsi
mvsktest	mvsktest
mvsumm	mvsumm
mvsumm7	mvsumm
mvt	mvtnorm
mvtden	mvtnorm
mvtest	mvtest
mvtobit	mvtobit
mvtobit_2ll	mvtobit
mvtobit_ll	mvtobit
myaxis	myaxis
mybspline	testjfe
mycd10	mycd10
mycd10_ff	mycd10
mycd10p	mycd10
mycolors	mycolours
mycolours	mycolours
mydatelabels	mydatelabels
mydays	mylabels
mygmm2s	itsp_ado
mygmmcue	itsp_ado
myicd10	mycd10
myicd10p	mycd10
mylabels	mylabels
mynormal	itsp_ado
mynormal1	mmsel
mynormal_lf	itsp_ado
mynormal_lf_d0	itsp_ado
mynormal_lf_d0_c1	itsp_ado
mypkg	mypkg
mypoislf	poisml
myregress	itsp_ado
myticks	mylabels
nacorr	egenmisc
nacov	egenmisc
namean	egenmisc
nargs	subsim_1
nasd	egenmisc
nasum	egenmisc
navar	egenmisc
nb_adjust	nb_adjust
nbercycles	nbercycles
nbfit	nbfit
nbin0lf	trnbin0
nbinlf	nbinreg
nbinreg	nbinreg
nbstrat	nbstrat
ncf	ncf
ncfinv	ncf
ncfn	ncf
ncfncp	ncf
ncfprob	ncf
nct	nct
nct2	nct
nct2inv	nct
nctinv	nct
nctn	nct
nctncp	nct
nctprob	nct
ncyear	egenmore
ndbci	ndbci
ndsub	sadi
nearest	nearest
nearmrg	nearmrg
nearstat	nearstat
nehtests	nehurdle
nehurdle	nehurdle
nehurdle_heckman	nehurdle
nehurdle_heckman_het	nehurdle
nehurdle_p	nehurdle
nehurdle_tobit	nehurdle
nehurdle_trunc	nehurdle
nehurdle_trunc_het	nehurdle
neigh	spautoc
neigh5	spautoc
neoclassical	neoclassical
netplot	netplot
netreg	netreg
network	network
network_components	network
network_convert	network
network_forest	network
network_import	network
network_map	network
network_meta	network
network_pattern	network
network_query	network
network_rank	network
network_setup	network
network_sidesplit	network
network_table	network
network_unset	network
newey2	newey2
newey2_p	newey2
neweydmexog	newey2
neweyvif	newey2
newsimpact	newsimpact
next	next
nextcpkgdlg	installpkg
ngram	ngram
ngram_core	ngram
ngram_example	ngram
nharvey	nharvey
nicedates	nicedates
niceest	niceest
nicelabels	nicelabels
niceloglabels	niceloglabels
nicewords	nicewords
nl_choi_support_interval	choi_lr_test
nlabel	fsum
nlces	itsp_ado
nlcheck	nlcheck
nlcorr	nlcorr
nldrm_constant	drm
nldrm_rowcol	drm
nlgmmcovearn	gmmcovearn
nligeset	igeset
nligesetci	igesetci
nlsur__quaidsce	quaidsce
nmiss	egenmore
nmissing	nmissing
nneighbor	itsp_ado
nnest	nnest
nnipolate	nnipolate
nnmatch	nnmatch
noccur	egenmore
nonparmde	nonparmde
nopomatch	nopomatch
norm	norm
normalbvr	normalbvr
normalizepath	normalizepath
normalreg_lf	fmm
normalrir	normalrir
normtest	normtest
npeivreg	npeivreg
npinfo	npinfo
npiv	npiv
npivcv	npiv
npresent	nmissing
nproc	nproc
npseries	npseries
npss	npss
npsynth	npsynth
nredound	regxfe
nrow	nrow
nruns	nruns
nrunsi	nruns
nscale	nscale
nspells	sadi
nsplit	nsplit
nss	egenmore
nstage	nstage
nstagebin	nstagebin
nstagebinopt	nstagebinopt
nstagemenu	nstage
ntos	egenmore
ntreatreg	ntreatreg
nuamodes	silvermtest
num2base26	num2base26
num2words	num2words
numdate	numdate
numids	spautoc
numids5	spautoc
numodes	silvermtest
nvals	egenmore
nvars	nvars
nwANND	nwannd
nwStrengthcent	nwstrengthcent
nw_fromlist	nw_fromlist
nw_projection	nw_projection
nw_wcc	nw_wcc
nwassortativity	nwassortativity
nwcluster	nwcluster
nwdisparity	nwdisparity
nwind	nwind
nwords	egenmore
nwreciprocity	nwreciprocity
nwspgr	rcl
nyblomstar3	gcrobustvar
nysiis	nysiis
nytimes	nytimes
oaxaca	oaxaca
oaxaca2	oaxaca8
oaxaca8	oaxaca8
oaxaca9	oaxaca9
oaxaca_rif	rif
oaxaca_rif_old	rif
obsdiff	obsdiff
obsofint	obsofint
obsofint_ex	obsofint
ocmt	ocmt
ocratio	ocratio
ocrpred	ocratio
oddsrisk	oddsrisk
odi	odi
odk2doc	odkexport
odk2xls	odkexport
odkmeta	odkmeta
odksplit	odksplit
oeratio	oeratio
oesch	oesch
ofrtplot	modeldiag
ofrtplot7	modeldiag
oglm	oglm
oglm9	oglm9
oglm9_ll	oglm9
oglm9_p	oglm9
oglm_ll	oglm
oglm_p	oglm
oglm_svy_check	oglm
oib_lf	zoib
oma	sadi
omav	sadi
omegacoef	omegacoef
omninorm	omninorm
omninorm7	omninorm
omodel	omodel
oneclick	oneclick
onespell	onespell
onetext	onetext
onewai	matrixtools
onewayplot	onewayplot
onewplot	onewplot
oparallel	oparallel
oparallel_ex	oparallel
opchar_curtailed	singlearm
opchar_fixed	singlearm
opchar_gs	singlearm
openall	openall
opencagegeo	opencagegeo
opencagegeoi	opencagegeo
opendir	fileutils
oplabdata	oplabdata
oppincidence	ceq
opplot	opplot
oprobpr	oprobpr
oprobpr7	oprobpr
optaspect	optaspect
optifact	optifact
ordcatsampsi	ordcatsampsi
ordplot	ordplot
ordvar	ordvar
orse	orse
orth_out	orth_out
orthog	orthog
osgen	osgen
osort	osort
outdat	outdat
outdat_limdep	outdat
outdat_rats	outdat
outdat_spss	outdat
outdat_sql	outdat
outdat_stata	outdat
outdetect	outdetect
outdisp	icalc
outfix	outfix
outfix2	outfix2
outfixt	outfixt
outputst	stcmd
outputstold	stcmd
outreg	outreg
outreg2	outreg2
outreg2_prf	outreg2
outreg5	outreg5
outseries	outseries
outshee2	desmat
outside	egenmore
outsum	outsum
outtable	outtable
outtable7	outtable
outtex	outtex
outtex6	outtex
outwrite	outwrite
ovbd	ovbd
overdisp	overdisp
overfit	overfit
overid	overid
overid9	overid
overlay	overlay
ovfplot	modeldiag
ovfplot7	modeldiag
ovport	mvport
p2ci	p2ci
pac2	panelauto
pagetrend	pagetrend
pair	lowyseattleb
pairdata	pairdata
pairplot	pairplot
pajek2stata	pajek2stata
palette_all	palette_all
pam	pam
panell	panell
panels	panels
panelthin	panelthin
panelview	panelview
pantest2	pantest2
paragr	paragr
parallel	parallel
parallel_append	parallel
parallel_bs	parallel
parallel_sim	parallel
paramed	paramed
paramedbs	paramed
paran	paran
paretofit	paretofit
paretofit_ll	paretofit
pariv	pariv
parmby	parmest
parmcip	parmest
parmest	parmest
parmhet	parmhet
parmiv	parmhet
parmparse	parmparse
parplot	parplot
parsefilename	smcl2do
parseloc	parseloc
parseuas	parseuas
partchart	partchart
partgam	partgam
partpred	partpred
partpred_examples	partpred
parttau	parttau
pascal	pascal
path	path
pathdiag	icalc
pathdiagfull	icalc
pathmaker	pathmaker
pathof	pathof
pathutil	pathutil
paverage	paverage
payper	payper
pbeta	pbeta
pbeta4	pbeta
pbpoint	pbreg
pbpredict	pbreg
pbreg	pbreg
pc	_gprop-_gpc
pc_dd_analytic	pcpanel
pc_dd_covar	pcpanel
pc_simulate	pcpanel
pca2	pca2
pcacoefsave	pcacoefsave
pcdid	pcdid
pcdsearch	pcdsearch
pchipolate	pchipolate
pciplot	pciplot
pcm	raschpower
pcm000101_lf	cureregr8
pcm000102_lf	cureregr8
pcm000103_lf	cureregr8
pcm000201_lf	cureregr8
pcm000202_lf	cureregr8
pcm000203_lf	cureregr8
pcm000301_lf	cureregr8
pcm000302_lf	cureregr8
pcm000303_lf	cureregr8
pcm000401_lf	cureregr8
pcm000402_lf	cureregr8
pcm000403_lf	cureregr8
pcm000501_lf	cureregr8
pcm000502_lf	cureregr8
pcm000503_lf	cureregr8
pcm010101_lf	cureregr8
pcm010102_lf	cureregr8
pcm010103_lf	cureregr8
pcm010201_lf	cureregr8
pcm010202_lf	cureregr8
pcm010203_lf	cureregr8
pcm010301_lf	cureregr8
pcm010302_lf	cureregr8
pcm010303_lf	cureregr8
pcm010401_lf	cureregr8
pcm010402_lf	cureregr8
pcm010403_lf	cureregr8
pcm010501_lf	cureregr8
pcm010502_lf	cureregr8
pcm010503_lf	cureregr8
pcmdif	pcmdif
pcmodel	pcmodel
pcmtest	pcmtest
pcontract	pcontract
pcorr2	pcorr2
pcorrmat	pcorrmat
pct9010	itsp_ado
pctrange	itsp_ado
pctrim	pctrim
pdagum	qpfit
pdc	pdc
pdd	pcdid
pddami	midas
pdfplot	pdfplot
pdi	pdi
pdi_outcome	pdi
pdplot	pdplot
pdslasso	pdslasso
peerreview	peerreview
peers	_peers
pem	pem
percat	percat
percentmatch	percentmatch
permin	percom
permtab	sadi
permtabga	sadi
personage	personage
persuasio	persuasio
persuasio4ytz	persuasio
persuasio4ytz2lpr	persuasio
persuasio4yz	persuasio
perturb	perturb
pescadf	pescadf
petpoisson	petpoisson
petpoisson_ll	petpoisson
petpoisson_me	petpoisson
pexit	pmanage
pexp	pexp
pexp5	pexp
pfs	pfs
pfwb	pfwb
pgamma	pgamma
pgamma4	pgamma
pgb2	qpfit
pgmhaz8	pgmhaz8
pgmhaz8_ll	pgmhaz8
pgumbel	gumbelfit
phack_deround	phack_deround
phecdf	panelhetero
phenotype	phenotype
phkd	panelhetero
phmoment	panelhetero
piaacdes	piaactools
piaacreg	piaactools
piaactab	piaactools
pick	egenmisc
pieplot	pieplot
piesch	egen_inequal
pindex	pindex
pinocchio	pinocchio
pinvgamma	invgammafit
pinvgauss	invgaussfit
pip	pip
pip_cache	pip
pip_cite	pip
pip_cl	pip
pip_clean	pip
pip_cleanup	pip
pip_drop	pip
pip_drop_frames	pip
pip_examples	pip
pip_find_src	pip
pip_gh	pip
pip_info	pip
pip_install	pip
pip_new_session	pip
pip_povcalnet_format	pip
pip_query	pip
pip_set_server	pip
pip_ssc	pip
pip_tables	pip
pip_update	pip
pip_versions	pip
pipe	pipe
pisacmd	pisatools
pisadeco	pisatools
pisaoaxaca	pisatools
pisaqreg	pisatools
pisareg	pisareg
pisastats	pisatools
pkonfound	konfound
plausexog	plausexog
plogn	qpfit
plognorm	qlognorm
plotb	plottabs
plotbeta	plotbeta
plotbetas	plottabs
plotcomb	icalc
plotinit	plottabs
plotm	plottabs
plotmatrix	plotmatrix
plotmeans	plottabs
plotprocess	qrprocess
plotrpys	plotrpys
plots	plottabs
plotsgpv	sgpv
plotshares	plottabs
plott	plottabs
plottabs	plottabs
plottwoway	plottabs
pls	pls
plssem	plssem
plssem_estat	plssem
plssem_p	plssem
plssemc	plssem
plssemc_estat	plssem
plssemcmat	plssem
plssemmat	plssem
plssemplot	plssem
plztowknr	plztowknr
pmcalplot	pmcalplot
pmidfetch	efetch_tools
pmsampsize	pmsampsize
pmvnormal	mvtnorm
png2rtf	png2rtf
pnrcheck	pnrcheck
pobrezaECU	pobrezaecu
pocvsw	posw_posis
poi2hdfe	poi2hdfe
poisml	poisml
polar	polar
polyspline	polyspline
poparms	poparms
poparms_p	poparms
popd	fileutils
popsim	popsim
posis	posw_posis
poslist	listutil
postbfm	bfmcorr
postlist	listutil
postrri	postrri
postsim	more_clarify
posw	posw_posis
poswbic_gmm_logit	posw_posis
poswbic_gmm_pois	posw_posis
povcalnet	povcalnet
povcalnet_aggquery	povcalnet
povcalnet_cl	povcalnet
povcalnet_clean	povcalnet
povcalnet_examples	povcalnet
povcalnet_info	povcalnet
povcalnet_query	povcalnet
povdeco	povdeco
povdeco5	povdeco
poverty	poverty
poverty_growth	pobrezaecu
poverty_overtendency	pobrezaecu
poverty_recovery	pobrezaecu
poverty_undertendency	pobrezaecu
povguide	povguide
povimp	povimp
povmap	sae
povtime	povtime
power_cmd_loa	power_loa
power_cmd_loa_init	power_loa
power_cmd_oneroc	power_oneroc
power_cmd_oneroc_init	power_oneroc
power_cmd_onesens	power_diagnostic
power_cmd_onesens_init	power_diagnostic
power_cmd_onespec	power_diagnostic
power_cmd_onespec_init	power_diagnostic
power_cmd_pairsens	power_diagnostic
power_cmd_pairsens_init	power_diagnostic
power_cmd_pairspec	power_diagnostic
power_cmd_pairspec_init	power_diagnostic
power_cmd_swgee	power_swgee
power_cmd_swgee_init	power_swgee
power_cmd_tworates_zhu	power_tworates_zhu
power_cmd_tworates_zhu_init	power_tworates_zhu
power_cmd_tworoc	power_roc
power_cmd_tworoc_init	power_roc
power_cmd_twosens	power_diagnostic
power_cmd_twosens_init	power_diagnostic
power_cmd_twospec	power_diagnostic
power_cmd_twospec_init	power_diagnostic
power_swgee_examples	power_swgee
powercal	powercal
powerclus	powerclus
powerfamily	groupseq
powermap	powermap
powerps	rpaxioms
powerq	powerq
powersim	powersim
powersimplot	powersim
pp	quantil2
pperron2	panelunit
ppml	ppml
ppml_fe_bias	ppml_fe_bias
ppml_panel_sg	ppml_panel_sg
ppmlhdfe	ppmlhdfe
ppmlhdfe_header	ppmlhdfe
ppmlhdfe_p	ppmlhdfe
ppplot	ppplot
ppschromy	ppschromy
ppssampford	ppssampford
pr1nx_lf	prob1nx
pre	pre
pre8	pre
predbasesurv	predsurv
predcalc	predcalc
predictms	multistate
predictu	xtoos
predsurv	predsurv
predxcat	predxcat
predxcon	predxcon
preliminary_changes	pobrezaecu
prelist	listutil
prem	python
prepar	prepar
preparation	preparation
pres2html	smclpres
pretrends	pretrends
pretty_baseline	pretty_baseline
primes	primes
printgph	printgph
prismscore	prismscore
prnt_cx	coldiag2
prob1nx	prob1nx
probat	xtpdyn
probcalc	probcalc
probexog	probexog-tobexog
probgenextval	probgenextval
probgenextval_ll	probgenextval
probgenextval_p	probgenextval
probitfe	probitfe
probitiv	probitiv
probitmiss	probitmiss
prod	_gprod
prodest	prodest
prodest_m	markupest
prodest_p	prodest
prodest_p_m	markupest
prodlist	listutil
prodvars	prodvars
prody	prody
profhap	profhap
progres	progres
projdo	lowyseattlea
project	project
projix	lowyseattleb
prolist	prolist
prop	_gprop-_gpc
propcnsasl	propcnsreg
propcnslogit_e2	propcnsreg
propcnslogit_lf	propcnsreg
propcnspoisson_e2	propcnsreg
propcnspoisson_lf	propcnsreg
propcnsreg	propcnsreg
propcnsreg_e2	propcnsreg
propcnsreg_ex	propcnsreg
propcnsreg_lf	propcnsreg
propcnsreg_p	propcnsreg
proprcspline	proprcspline
proprcspline_ex	proprcspline
proprstr	icalc
prosperity	prosperity
prsnperd	dthaz
prtab	prtab
prwe	prwe
psacalc	psacalc
psacalci	psacalc
psave	pmanage
psbayes	psbayes
psbayes6	psbayes
psbayesm	matodd
pschdb	subsim_1
pschdes	subsim_1
pschini	subsim_1
pschini2	subsim_1
pschinis	subsim_1
pschset	subsim_1
pschsetn	subsim_1
pschsetv	subsim_1
psemail	psemail
psestimate	psestimate
psgraph	psmatch2
pshare	pshare
psid	psidtools
psid_install	psidtools
psid_long	psidtools
psid_vardoc	psidtools
psidadd	psiduse
psiduse	psiduse
psimulate2	simulate2
psm	qpfit
psmatch2	psmatch2
pspline	pspline
psreg	psreg
pssbounds	dynardl
pstest	psmatch2
pstest2	psmatch2
pstrata	pstrata
psweight	psweight
ptrend	ptrend
ptrendi	ptrend
pullin	pullin
punaf	punaf
punaf_p	punaf
punafcc	punafcc
punafcc_p	punafcc
puse	pmanage
pushd	fileutils
putdocxcrosstab	putdocxcrosstab
putdocxfreqtable	putdocxfreqtable
putwrap	putwrap
pv	pv
pv0	pv
pval_fixed	singlearm
pval_gs	singlearm
pvcalc	gcrobustvar
pvenn	pvenn
pvfix	pvfix
pvtest	pv
pvvar	pvvar
pvw	pvw
pvwcalc	pvw
pwcorr2	pwcorr2
pwcorrf	pwcorrf
pwcorrs	pwcorrs
pwcorrw	pwcorrw
pwcov	pwcov
pweibull	pweibull
pweibull4	pweibull
pwexp	pwexp
pwlaw	pwlaw
pwmc	pwmc
pwmci	pwmc
pwploti	pwploti
pyconvertu	pyconvertu
pyex	pyex
pylearn	r_ml_stata_cv
pystacked	pystacked
pystacked_p	pystacked
python	python
pzms	pzms
pzms_custom	pzms
qap	qap
qbeta	qbeta
qbeta4	qbeta
qcolname	qrowname
qconvert	qconvert
qcount	qcount
qcount_mfx	qcount
qdagum	qpfit
qddml	ddml
qenvF	qenv
qenv_ex	qenv
qenv_sim_F	qenv
qenv_sim_beta	qenv
qenv_sim_chi2	qenv
qenvbeta	qenv
qenvchi2	qenv
qenvgamma	qenv
qenvnormal	qenv
qexp	qexp
qexp5	qexp
qfactor	qfactor
qfrplot	modeldiag
qfrplot7	modeldiag
qgamma	qgamma
qgamma4	qgamma
qgb2	qpfit
qgumbel	gumbelfit
qhapipf	qhapipf
qhapupdate	qhapipf
qic	qic
qinvgamma	invgammafit
qinvgauss	invgaussfit
qlabel	lowyseattleb
qlist	cart
qll	qll
qlogn	qpfit
qlognorm	qlognorm
qlqc15	qlqc15
qn	qn
qogbook	qogbook
qogmerge	qog
qoguse	qog
qpair	qpair
qqcompare	qqcompare
qqplot2	qqplot2
qqplot3	qqplot3
qqplotg	qqplotg
qqvalue	qqvalue
qreg2	qreg2
qregb	mmsel
qregpd	qregpd
qregplot	qregplot
qregsel	qregsel
qregsel_p	qregsel
qrisk2cmd	qrisk2cmd
qrisk2export	qrisk2cmd
qrisk2import	qrisk2cmd
qrkd	qrkd
qrowname	qrowname
qrprocess	qrprocess
qrprocess_p	qrprocess
qsim	qsim
qsm	qpfit
qsortidx	geneigen
qsub	qsub
quadas	quadas
quaidsce	quaidsce
quaidsce_estat	quaidsce
quaidsce_p	quaidsce
qualtricsload	qualtricsload
quandl	quandl
quantil2	quantil2
quantiles	quantiles
quickicc	quickicc
quine	quine
qv	qv
qv_example	qv
qvgraph	qv
qweibull	qweibull
qweibull4	qweibull
r2_mz	r2_mz
r2c	r2c
r2nlsur	r2nlsur
r2o	r2o
r2reg3	r2reg3
r2sem	r2sem
r2var	r2var
r_ml_stata_cv	r_ml_stata_cv
r_ml_stata_default	r_ml_stata_cv
r_to_d	r_to_d
racplot	modeldiag
radar	radar
radf	radf
radf0	radf
radiusmatch	radiusmatch
raewma	raewma
rall	egenmore
ralloc	ralloc
ralloc_678	ralloc
ralpha	ralpha
randcmd	randcmd
randcmdci	randcmdci
randcoef	randcoef
randid	lowyseattleb
randinf	randinf
randomforest_predict	rforest
randomize	randomize
randomselect	randomselect
randomtag	randomtag
randtreat	randtreat
randtreatseq	randtreatseq
rangejoin	rangejoin
rangejoin_run	rangejoin
rangerun	rangerun
rangerun_run	rangerun
rangestat	rangestat
rangestat_run	rangestat
rankseg	rankseg
ranktest	ranktest
ranktest11	ranktest
ranktest9	ranktest
ranova	ranova
ranvar	ranvar
ranvar2	ranvar
ranwtdttt	wtdttt
rany	egenmore
ras	ras
raschcvt	raschcvt
raschfit	raschfit
raschify	raschify
raschpower	raschpower
raschtest	raschtest
raschtestv7	raschtestv7
rasprt	rasprt
rassign	rassign
rbiprobit	rbiprobit
rbiprobit_lf1	rbiprobit
rbiprobit_margdec	rbiprobit
rbiprobit_p	rbiprobit
rbiprobit_tmeffects	rbiprobit
rbounds	rbounds
rc2	rc2
rc_spline	rc_spline
rca	rca
rccount	zb_qrm
rcd	rcd
rcentile	rcentile
rcform	icalc
rcl	rcl
rcm	rcm
rcod	tcod
rcolp2mat	rcolp2mat
rcount	egenmore
rcs	strsrcs
rcsgen	rcsgen
rcsgen2	staft
rcsgen_example	rcsgen
rcspc	emc
rcspline	rcspline
rct_minim	rct_minim
rctable	rctable
rctmiss	rctmiss
rctmiss_smlik	rctmiss
rd	rd
rd_obs	rd
rdatasets	rdatasets
rdbalance	rdbalance
rdbwdensity	rddensity
rdbwselect	rdrobust
rdbwselect_2014	rdrobust
rdbwselect_2014_kconst	rdrobust
rdci	rdci
rdcii	rdci
rdcont	rdcont
rdcv	rdcv
rddensity	rddensity
rddsga	rddsga
rdecompose	rdecompose
rdesigni	rdesigni
rdexo	rdexo
rdiff	rdiff
rdmse	rdmse
rdmsef	rdmse
rdmses	rdmse
rdmses2s	rdmse
rdmses_cct2014	rdmse
rdpermute	rdpermute
rdplot	rdrobust
rdplot7	modeldiag
rdpower	rdpower
rdqte	rdqte
rdrobust	rdrobust
rds	rds
rds_network	rds
read_convergence	runmplus
read_differencetest	runmplus
read_parameterestimates	runmplus
read_parameterestimates_general	runmplus
read_parameterestimates_indirect	runmplus
read_residual_variance	runmplus
readfile	readwind
readlog	readlog
readonly	lowyseattlea
readreplace	readreplace
readshare	readshare
readwind	readwind
realcomimpute	realcomimpute
realcomimputeload	realcomimpute
recap	recap
recast2	recast2
recent	lowyseattlea
reclass	perturb
reclink	reclink
recocl	recocl
recode2	recode2
recol	recol
record	egenmore
redi	redi
reffadjust4nlcom	reffadjust
reffadjustsim	reffadjust
reffect	reffect
reformat	reformat
reg2docx	reg2docx
reg2hdfe	reg2hdfe
reg2logit	reg2logit
reg_sandwich	reg_sandwich
reg_ss	reg_ss
regall	regall
reganat	reganat
regaxis	regaxis
regcheck	regcheck
regcoef	regcoef
regdis	regdis
regen	regen
regfit	regfit
reggae_music	reggae_music
reghdfe	reghdfe
reghdfe_estat	reghdfe
reghdfe_footnote	reghdfe
reghdfe_header	reghdfe
reghdfe_old	reghdfe
reghdfe_old_estat	reghdfe
reghdfe_old_footnote	reghdfe
reghdfe_old_p	reghdfe
reghdfe_p	reghdfe
reghdfe_parse	reghdfe
reghdfe_store_alphas	reghdfe
regife	regife
regintfe	regintfe
reglike	reglike
regmain	regmain
regmat	matrixtools
regoprob	regoprob
regoprob2	regoprob2
regoprob2_autofit	regoprob2
regoprob_ll	regoprob
regoprob_llc	regoprob
regoprob_p	regoprob
regpar	regpar
regpar_p	regpar
regplot	modeldiag
regplot7	modeldiag
regpred	regpred
regresby	regresby
regsave	regsave
regsave_tbl	regsave
regsen	regsensitivity
regsensitivity	regsensitivity
regsets	regall
regtable	regtable
regwls	regwls
regxfe	regxfe
rel_clust	rel_clust
reldist	reldist
reldist_svyr	reldist
relicoef	relicoef
relogit	relogit
relogitq	relogit
relrank	relrank
rely	rely
relyplot	relyplot
remcor	gllamm
remr	remr
renamefrom	encodefrom
renames	renames
renfiles	renfiles
rensheet	rensheet
renvarlab	renvarlab
reorder	reorder
repcmd	storecmd
repcmd6	storecmd
repeat	egenmore
repest	repest
replacebylab	replacebylab
replacen	replacen
replist	listutil
report	report
reportcheck	weaver
reporterror	reporterror
repsample	repsample
reset	reset
reset2	reset2
resetxt	resetxt
reshape3	reshape3
reshape8	reshape8
resize	resize
resizec1leg	resize
resizecombine	resize
resp	resp
respdiff	respdiff
results	weaver
reswage	reswage
reswage_ll	reswage
retroclassical	neoclassical
retrodesign	retrodesign
returnsyh	mvport
reu	reu
rev	rev
revcat	revcat
revcat_ll	revcat
revcat_pred	revcat
revlist	listutil
revrs	revrs
revv	revv
reweight	reweight
reweight2	reweight2
rewrite	rewrite
rfl	rfl
rflbdlg	rfl
rflsetmenu	rfl
rfluse	rfl
rforest	rforest
rforest_examples	rforest
rfregk	rfregk
rgb2	rgb2
rglm	rglm
rgroup	rgroup
rhausman	rhausman
rhetplot	modeldiag
rho_xtregar	rho_xtregar
rhsbsample	rhsbsample
richness	richness
ridder	ridder
ridge2sls	ridge2sls
ridgeline_plot	ridgeline_plot
ridgereg	ridgereg
ridgeregress	elasticregress
ridit	egenmore
rifhdreg	rif
rifle	rifle
riflogit	riflogit
riflogit_RIF	riflogit
riflogit_p	riflogit
rifmean	rif
rifsureg	rif
rifsureg2	rif
rifvar	rif
rifvar_old	rif
rightalign	leftalign
rii	rii
riigen	riigen
rioc	rioc
rioci	rioc
ritest	ritest
rkqte	rkqte
rlasso	lassopack
rlasso_p	lassopack
rlassologit	lassopack
rmanova	rmanova
rmargb	grcompare
rmargd	grcompare
rmclass	rmclass
rmcorr	rmcorr
rmd	egen_inequal
rmedf	_grmedf
rmfiles	rmfiles
rmhbounds	rmhbounds
rmloa	rmloa
rmpw	rmpw
rmse	rmse
rmvnormal	mvtnorm
rmvt	mvtnorm
rndbb	rnd
rndbin	rnd
rndbinx	rnd
rndchi	rnd
rndexp	rnd
rndf	rnd
rndgam	rnd
rndgamx	rnd
rndglog	rnd
rndint	egenmore
rndivg	rnd
rndivgx	rnd
rndlgn	rnd
rndnblx	rnd
rndpod	rnd
rndpodx	rnd
rndpoi	rnd
rndpoix	rnd
rndraw	_grndraw
rndsub	egenmore
rndt	rnd
rndvm	circular
rndwei	rnd
robbox	robbox
robit	robit
robit1	xlink
robit10	xlink
robit2	xlink
robit3	xlink
robit4	xlink
robit5	xlink
robit6	xlink
robit7	xlink
robit8	xlink
robit9	xlink
robjb	robjb
robksm	adjksm
roblpr	roblpr
robmv	robmv
robmv_p	robmv
robnova	robnova
robreg	robreg
robreg10	robreg10
robstat	robstat
robumeta	robumeta
robustate	robustate
robustpf	robustpf
rocauc	nproc
roccov	nproc
rocmic	rocmic
rocplot	nproc
rocse	nproc
rocss	rocss
roctabi	roctabi
rolling2	rolling2
rolling3	rolling3
rollreg	rollreg
rollstat	rollstat
romantoarabic	romantoarabic
rori	rori
ros	ros
rosali	rosali
rosssekh	rosssekh
rotate2	rotate2
rotlist	listutil
rowmedian	egenmore
rownvals	egenmore
rowranks	rowranks
rowsort	rowsort
rowsort6	rowsort
rowsum	rowsum
rowsvals	egenmore
rpme	rpme
rpos	_grpos
rprod	_grprod
rq	rq
rqr	rqr
rqrplot	rqr
rqrs	rqrs
rrc	lowyseattleb
rrcalc	rrcalc
rrlogit	rrlogit
rrlogit_lf	rrlogit
rrlogit_p	rrlogit
rrp	rrp
rrr	rrr
rrreg	rrreg
rscore	rscore
rscript	rscript
rsens	rsens
rsgt	rsgt
rsoort	rsoort
rsort	rsort
rsource	rsource
rspeedindex	rspeedindex
rsum2	egenmore
rsz	rsz
rtfappend	rtfutil
rtfclose	rtfutil
rtfcumlist	rtfutil
rtfhyper	rtfutil
rtfinsert	rtfutil
rtflink	rtfutil
rtfopen	rtfutil
rtfrstyle	rtfutil
rtfsect	rtfutil
rtm_calc	rtmci
rtmci	rtmci
rtmcii	rtmci
rtmvnormal	mvtnorm
rtmvt	mvtnorm
rts	icdpic
rtvand	trinary
rtvor	trinary
runby	runby
runby_run	runby
runcd	docd
runmixreg	runmixregls
runmixregls	runmixregls
runmixregmls	runmixregls
runmlwin	runmlwin
runmlwin_mcmcdiag	runmlwin
runmlwin_qshell	runmlwin
runmlwin_verinfo	runmlwin
runmplus	runmplus
runmplus_fits	runmplus
runmplus_load_savedata	runmplus
running	running
runparscale	runparscale
rvfplot2	modeldiag
rvfplot27	modeldiag
rvlrplot	modeldiag
rvlrplot7	modeldiag
rvpplot2	modeldiag
rvpplot27	modeldiag
rwg	rwg
rwolf	rwolf
rwolf2	rwolf2
rwrmed	rwrmed
rwrmed_calc	rwrmed
rxdays	lowyseattleb
rxdose	lowyseattleb
sae	sae
sae_closefiles	sae
sae_data_export	sae
sae_data_import	sae
sae_proc_inds	sae
sae_proc_stats	sae
safedrop	safedrop
sampicc	sampicc
samplepps	samplepps
samplesize	samplesize
sampsi_fleming	sampsi_fleming
sampsi_gehan	sampsi_gehan
sampsi_mcc	sampsi_mcc
sampsi_reg	sampsi_reg
sampsi_rho	sampsi_rho
sampsi_sccs	sampsi_sccs
sankey	sankey
sankey_plot	sankey_plot
sankeyplot	sankeyplot
sankeyplot_eg	sankeyplot
sasexe	usesas
saswrapper	saswrapper
savasas	savasas
save12	save12
save13	save13
save9	save9
saveascii	saveascii
savegz	gziputil
savel	lowyseattlea
saveresults	saveresults
savesaslabs	lowyseattleb
savesome	savesome
savespss	savespss
savespss_dlgs	savespss
savespsssome	savespss
savewsz	runmlwin
sbbq	sbbq
sbldo	sbldo
sblsf	sblsf
sbmeff	sbmeff
sbplot	sbplot
sbplot5	sbplot5
sbri	sbri
sbrowni	sbrowni
scale_transformation	scale_transformation
scandata	scandata
scat3	scat3
scatter3d	scatter3d
scattercub	cub
scatterfit	scatterfit
scatyhat	icalc
sccendif	scsomersd
sccenslope	scsomersd
scdcor	scdensity
scdensity	scdensity
scdsweight	dsweight
scenreg	scenreg
scenreg_lf	scenreg
scenttest	scenttest
scenttest_p	scenttest
scfcombo	scfcombo
scheme-scientific_ex	scheme_scientific
scls	scls
scm	scm
scmod1	icalc
scmod2	icalc
scoregof	scoregof
scoregrp	scoregrp
scores	scores
scoretest	boottest
scoretest_cox	stcoxgof
screen	screen
screenmatches	mahapick
scsomersd	scsomersd
sctoapi	scto
sctomedia	scto
sctorezone	scto
sctostreamcsv	scto
sctostreamsum	scto
sctree	sctree
scul	scul
sdchronogram	sadi
sdchronoplot	sadi
sddiscrep	sadi
sdecode	sdecode
sdentropy	sadi
sdhamming	sadi
sdhollister	sadi
sdid	sdid
sdindexplot	sadi
sdist	sdist
sdl	egen_inequal
sdlim	sdlim
sdline	sdline
sdmxHelp	getdata
sdmxuse	sdmxuse
sdplot	sadi
sdstripe	sadi
sdtest	sdtest
sdtesti	sdtest
searchfor	searchfor
searchr	searchr
seast	seast
seconds	egenmore
seeout	outreg2
seg	seg
seldum	seldum
selectvars	selectvars
sellist	listutil
semdiagram	diagram
semean	semean
semipar	semipar
sencode	sencode
sendtoslack	sendtoslack
sensatt	sensatt
sensemakr	sensemakr
sensimatch	sensimatch
senspec	senspec
sentinel	sentinel
sepscatter	sepscatter
seq	seq
seqfind	seqfind
seqlist	listutil
seqlogit	seqlogit
seqlogit10	seqlogit
seqlogit10_p	seqlogit
seqlogit_lf	seqlogit
seqlogit_p	seqlogit
seqlogit_uh_lf	seqlogit
seqlogitdecomp	seqlogit
seqlogitdecomp10	seqlogit
seqsens	seqlogit
sequence	sequence
setdtapaper	dtapaper
setpoisson	setpoisson
setpoisson_ll	setpoisson
setpoisson_me	setpoisson
setrngseed	setrngseed
setx	relogit
setxHL	relogit
sf12	sf12
sf36	sf36
sf36fr	sf36fr
sf36v2	sf36v2
sfcross	sfcross
sfcross_p	sfcross
sfkk	sfkk
sfkk_ml	sfkk
sfpanel	sfpanel
sfpanel_p	sfpanel
sgini	sgini
sginicorr	sgini
sgpower	sgpv
sgpv	sgpv
sgpvalue	sgpv
sgtevaluator	sgtreg
sgtreg	sgtreg
shakespeare	shakespeare
shapley	shapley
shapley2	shapley2
sheafcoef	sheafcoef
sheafcoef_ex	sheafcoef
shellout	outreg2
shortdir	shortdir
shorth	shorth
showgph	showgph
shownear	shownear
showtrms	desmat
shp2dta	shp2dta
shuffle	shuffle
shuffle8	shuffle8
shufflevar	shufflevar
shufstr	itsp_ado
sicff	sicff
sieve	egenmore
sigcoef	sigcoef
sigreg	icalc
silhouette	silhouette
silvtest1	silvermtest
sim_dtl	desma
sim_ma	desma
sim_mams	desma
simarwilson	simarwilson
simirt	simirt
simon2stage	simon2stage
simpctile	itsp_ado
simple_ra	randomizr
simport	mvport
simpplot	simpplot
simpute	simpute
simqi	clarify
simqoi	more_clarify
simsum	simsum
simulate2	simulate2
simuped2	simuped
simuped3	simuped
single	mmsel
single1	mmsel
singleb	singleb
singleb_ll	singleb
sinvdesc	invdesc
sivqr	sivqr
sivreg	sivreg
sixplot	sixplot
sizefx	sizefx
skbim	skbim
skdecomp	skdecomp
skewplot	skewplot
skewplot6	skewplot
skewreg	skewreg
skewt	hallt-skewt
skilmack	skilmack
sknor	sknor
skprobit	skprobit
sliceplot	sliceplot
slideplot	slideplot
slideviewer	slideviewer
slist	slist
slope	_gslope
slopefit	scatterfit
slopepower	slopepower
slower	sproper
sls	sls
sls_p	sls
smcfcs	smcfcs
smcl2do	smcl2do
smclpres	smclpres
smfit	smfit
smfit_ll	smfit
smgfit	smgfit
smgfit_ll	smgfit
smhsiao	smhsiao
smileplot	smileplot
smileplot7	smileplot
smithwelch	smithwelch
smpred	smfit
smrcol	smrtbl
smrfmn	smrtbl
smrgivconditions	smrtbl
smrtbl	smrtbl
smvcir	smvcir
smvcir_p	smvcir
snpfetch	efetch_tools
sob	sob
soepadd	soepuse
soepdo	soepdo
soepren	soepren
soepuse	soepuse
solvcui	kaputil
solve	solve
solvebvquad	icalc
solvqui	kaputil
somers_p	somersd
somersd	somersd
songbl	songbl
soreg	soreg
sortl	sortl
sortlist	listutil
sortlistby	sortlistby
sortlistby2	sortlistby
sortmean	upsetplot
sortobs	sortobs
sortrows	sortrows
sotable	sotable
sotable_getextract	sotable
soundex	_gsoundex
source	lowyseattleb
spaces	spaces
spagg	spagg
sparkline	sparkline
sparl	sparl
spatial_hac_iv	spatial_hac_iv
spautoc	spautoc
spautoc5	spautoc
spautodurhm	spautoreg
spautodurne	spautoreg
spautodurnn	spautoreg
spautodurnw	spautoreg
spautoerrne	spautoreg
spautoerrnn	spautoreg
spautoerrnw	spautoreg
spautolaghm	spautoreg
spautolagne	spautoreg
spautolagnn	spautoreg
spautolagnw	spautoreg
spautoreg	spautoreg
spautosacne	spautoreg
spautosacnn	spautoreg
spautosacnw	spautoreg
spcs2xt	spcs2xt
spdir	spdir
spearman2	spearman2
spec_stand	spec_stand
specc	specc
speccheck	speccheck
spechist	spechist
special_cases	fuzzydid
spectdens	spectdens
speedergles	speedergles
spell	spell
spell2panel	spellutil
spellmerge	spellutil
spellsplit	spellutil
spgen	spgen
spglsxt	spglsxt
spgmm	spgmm
spgmmxt	spgmmxt
spgrid	spgrid
sphdist	sphdist
spider	spider
spike	spike
spikeplt	spikeplt
spineplot	spineplot
spivreg	sppack
spkde	spkde
splagvar	splagvar
splagvar_randper	splagvar
split	split
splitit	splitit
splitlog	smcl2do
splitpath	docd
splitvallabels	splitvallabels
spmap	spmap
spmap_arrow	spmap
spmap_color	spmap
spmap_diagram	spmap
spmap_examples	spmap
spmap_label	spmap
spmap_line	spmap
spmap_point	spmap
spmap_polygon	spmap
spmap_psl	spmap
spmap_scalebar	spmap
spmat	sppack
spmlreg	spmlreg
spmlreg_error	spmlreg
spmlreg_estat	spmlreg
spmlreg_lag	spmlreg
spmlreg_sac	spmlreg
spmon	spmon
spmstar	spmstar
spmstar1_lf	spmstar
spmstar2_lf	spmstar
spmstar3_lf	spmstar
spmstar4_lf	spmstar
spmstard	spmstard
spmstard1	spmstard
spmstard2	spmstard
spmstard3	spmstard
spmstard4	spmstard
spmstard5	spmstard
spmstard6	spmstard
spmstard7	spmstard
spmstard8	spmstard
spmstardh	spmstardh
spmstardh1	spmstardh
spmstardh2	spmstardh
spmstardh3	spmstardh
spmstardh4	spmstardh
spmstardhxt	spmstardhxt
spmstardhxt1	spmstardhxt
spmstardhxt2	spmstardhxt
spmstardhxt3	spmstardhxt
spmstardhxt4	spmstardhxt
spmstardxt	spmstardxt
spmstardxt01	spmstardxt
spmstardxt02	spmstardxt
spmstardxt03	spmstardxt
spmstardxt04	spmstardxt
spmstardxt05	spmstardxt
spmstardxt06	spmstardxt
spmstardxt07	spmstardxt
spmstardxt08	spmstardxt
spmstardxt09	spmstardxt
spmstardxt10	spmstardxt
spmstardxt11	spmstardxt
spmstardxt12	spmstardxt
spmstarh	spmstarh
spmstarh1	spmstarh
spmstarh2	spmstarh
spmstarh3	spmstarh
spmstarh4	spmstarh
spmstarxt	spmstarxt
spmstarxt01	spmstarxt
spmstarxt02	spmstarxt
spmstarxt03	spmstarxt
spmstarxt04	spmstarxt
spmstarxt05	spmstarxt
spmstarxt06	spmstarxt
spmstarxt07	spmstarxt
spmstarxt08	spmstarxt
spmstarxt09	spmstarxt
spmstarxt10	spmstarxt
spmstarxt11	spmstarxt
spmstarxt12	spmstarxt
spnorm	spnorm
spread	tidy
spreg	sppack
spreg_estat	sppack
spreg_p	sppack
spregcs	spregcs
spregcs01	spregcs
spregcs02	spregcs
spregcs03	spregcs
spregcs04	spregcs
spregcs05	spregcs
spregcs06	spregcs
spregcs07	spregcs
spregcs08	spregcs
spregcs09	spregcs
spregcs10	spregcs
spregcs11	spregcs
spregcs12	spregcs
spregcs13	spregcs
spregcs14	spregcs
spregcs15	spregcs
spregcs16	spregcs
spregcs17	spregcs
spregcs18	spregcs
spregcs19	spregcs
spregcs20	spregcs
spregcs21	spregcs
spregcs22	spregcs
spregcs23	spregcs
spregcs24	spregcs
spregcs25	spregcs
spregcs26	spregcs
spregcs27	spregcs
spregcs28	spregcs
spregcs29	spregcs
spregcs30	spregcs
spregcs31	spregcs
spregcs32	spregcs
spregcs33	spregcs
spregcs34	spregcs
spregcs35	spregcs
spregcs36	spregcs
spregcs37	spregcs
spregdhp	spregdhp
spregdpd	spregdpd
spregfext	spregfext
spreghetxt	spreghetxt
spreghetxt1	spreghetxt
spreghetxt2	spreghetxt
spregrext	spregrext
spregsac	spregsac
spregsac1	spregsac
spregsac2	spregsac
spregsac3	spregsac
spregsacxt	spregsacxt
spregsacxt1	spregsacxt
spregsacxt2	spregsacxt
spregsacxt3	spregsacxt
spregsar	spregsar
spregsar1	spregsar
spregsar2	spregsar
spregsar3	spregsar
spregsar4	spregsar
spregsarxt	spregsarxt
spregsarxt1	spregsarxt
spregsarxt2	spregsarxt
spregsarxt3	spregsarxt
spregsdm	spregsdm
spregsdm1	spregsdm
spregsdm2	spregsdm
spregsdm3	spregsdm
spregsdm4	spregsdm
spregsdmxt	spregsdmxt
spregsdmxt1	spregsdmxt
spregsdmxt2	spregsdmxt
spregsdmxt3	spregsdmxt
spregsdmxt4	spregsdmxt
spregsem	spregsem
spregsem1	spregsem
spregsem2	spregsem
spregsem3	spregsem
spregsemxt	spregsemxt
spregsemxt1	spregsemxt
spregsemxt2	spregsemxt
spregsemxt3	spregsemxt
spregxt	spregxt
spregxt01	spregxt
spregxt02	spregxt
spregxt03	spregxt
spregxt04	spregxt
spregxt05	spregxt
spregxt06	spregxt
spregxt07	spregxt
spregxt08	spregxt
spregxt09	spregxt
spregxt10	spregxt
spregxt11	spregxt
spregxt12	spregxt
spregxt13	spregxt
spregxt14	spregxt
spregxt15	spregxt
spregxt16	spregxt
spregxt17	spregxt
spregxt18	spregxt
spregxt19	spregxt
spregxt20	spregxt
spregxt21	spregxt
spregxt22	spregxt
spregxt23	spregxt
spregxt24	spregxt
spregxt25	spregxt
spregxt26	spregxt
spregxt27	spregxt
spregxt28	spregxt
spregxt29	spregxt
spregxt30	spregxt
spregxt31	spregxt
spregxt32	spregxt
spregxt33	spregxt
spregxt34	spregxt
spregxt35	spregxt
spregxt36	spregxt
spregxt37	spregxt
sproper	sproper
spseudor2	spseudor2
spspc	spspc
spsur_ll	spsurv
spsurv	spsurv
sptobitmstar	sptobitmstar
sptobitmstar1	sptobitmstar
sptobitmstar2	sptobitmstar
sptobitmstar3	sptobitmstar
sptobitmstar4	sptobitmstar
sptobitmstar5	sptobitmstar
sptobitmstar6	sptobitmstar
sptobitmstar7	sptobitmstar
sptobitmstar8	sptobitmstar
sptobitmstard	sptobitmstard
sptobitmstard2	sptobitmstard
sptobitmstard3	sptobitmstard
sptobitmstard4	sptobitmstard
sptobitmstard5	sptobitmstard
sptobitmstard6	sptobitmstard
sptobitmstard7	sptobitmstard
sptobitmstard8	sptobitmstard
sptobitmstardh	sptobitmstardh
sptobitmstardh1	sptobitmstardh
sptobitmstardh2	sptobitmstardh
sptobitmstardh3	sptobitmstardh
sptobitmstardh4	sptobitmstardh
sptobitmstardhxt	sptobitmstardhxt
sptobitmstardhxt1	sptobitmstardhxt
sptobitmstardhxt2	sptobitmstardhxt
sptobitmstardhxt3	sptobitmstardhxt
sptobitmstardhxt4	sptobitmstardhxt
sptobitmstardxt	sptobitmstardxt
sptobitmstardxt01	sptobitmstardxt
sptobitmstardxt02	sptobitmstardxt
sptobitmstardxt03	sptobitmstardxt
sptobitmstardxt04	sptobitmstardxt
sptobitmstardxt05	sptobitmstardxt
sptobitmstardxt06	sptobitmstardxt
sptobitmstardxt07	sptobitmstardxt
sptobitmstardxt08	sptobitmstardxt
sptobitmstardxt09	sptobitmstardxt
sptobitmstardxt10	sptobitmstardxt
sptobitmstardxt11	sptobitmstardxt
sptobitmstardxt12	sptobitmstardxt
sptobitmstarh	sptobitmstarh
sptobitmstarh1	sptobitmstarh
sptobitmstarh2	sptobitmstarh
sptobitmstarh3	sptobitmstarh
sptobitmstarh4	sptobitmstarh
sptobitmstarhxt	sptobitmstarhxt
sptobitmstarhxt1	sptobitmstarhxt
sptobitmstarhxt2	sptobitmstarhxt
sptobitmstarhxt3	sptobitmstarhxt
sptobitmstarhxt4	sptobitmstarhxt
sptobitmstarxt	sptobitmstarxt
sptobitmstarxt01	sptobitmstarxt
sptobitmstarxt02	sptobitmstarxt
sptobitmstarxt03	sptobitmstarxt
sptobitmstarxt04	sptobitmstarxt
sptobitmstarxt05	sptobitmstarxt
sptobitmstarxt06	sptobitmstarxt
sptobitmstarxt07	sptobitmstarxt
sptobitmstarxt08	sptobitmstarxt
sptobitmstarxt09	sptobitmstarxt
sptobitmstarxt10	sptobitmstarxt
sptobitmstarxt11	sptobitmstarxt
sptobitmstarxt12	sptobitmstarxt
sptobitsac	sptobitsac
sptobitsac1	sptobitsac
sptobitsac2	sptobitsac
sptobitsac3	sptobitsac
sptobitsacxt	sptobitsacxt
sptobitsacxt1	sptobitsacxt
sptobitsacxt2	sptobitsacxt
sptobitsacxt3	sptobitsacxt
sptobitsar	sptobitsar
sptobitsar1	sptobitsar
sptobitsar2	sptobitsar
sptobitsar3	sptobitsar
sptobitsar4	sptobitsar
sptobitsarxt	sptobitsarxt
sptobitsarxt1	sptobitsarxt
sptobitsarxt2	sptobitsarxt
sptobitsarxt3	sptobitsarxt
sptobitsarxt4	sptobitsarxt
sptobitsdm	sptobitsdm
sptobitsdm1	sptobitsdm
sptobitsdm2	sptobitsdm
sptobitsdm3	sptobitsdm
sptobitsdm4	sptobitsdm
sptobitsdmxt	sptobitsdmxt
sptobitsdmxt1	sptobitsdmxt
sptobitsdmxt2	sptobitsdmxt
sptobitsdmxt3	sptobitsdmxt
sptobitsdmxt4	sptobitsdmxt
sptobitsem	sptobitsem
sptobitsem1	sptobitsem
sptobitsem2	sptobitsem
sptobitsem3	sptobitsem
sptobitsemxt	sptobitsemxt
sptobitsemxt1	sptobitsemxt
sptobitsemxt2	sptobitsemxt
sptobitsemxt3	sptobitsemxt
spundir	spundir
spweight	spweight
spweightcs	spweightcs
spweightxt	spweightxt
spwmatfill	spwmatfill
spwmatrix	spwmatrix
spxtivdfreg	xtivdfreg
spxtivdfreg_estat	xtivdfreg
spxtivdfreg_p	xtivdfreg
spxttobit	spxttobit
sqallpos	sq
sqclusterdat	sq
sqclustermat	sq
sqdes	sq
sqdt	sq
sqelemcount	sq
sqepicount	sq
sqfirstpos	sq
sqfreq	sq
sqgapcount	sq
sqgaplength	sq
sqindexplot	sq
sqitemcount	sq
sql	lowyseattlea
sqlength	sq
sqli	lowyseattlea
sqmarkpattern	sq
sqmc	sqmc
sqmdsadd	sq
sqmodalplot	sq
sqn	sqn
sqom	sq
sqomplug	sq
sqparcoord	sq
sqpercentageplot	sq
sqr	sqr
sqranks	sq
sqset	sq
sqstatlist	sq
sqstatsum	sq
sqstattab1	sq
sqstattab2	sq
sqstattabsum	sq
sqstrlev	sq
sqstrmerge	sq
sqstrnn	sq
sqtab	sq
sqtostring	sq
sratio	sratio
sregress	mm_regress
sreweight	sreweight
srform	icalc
srr	icdpic
srslogit	srslogit
srtbayes	eefanalytics
srtfreq	eefanalytics
srtree	srtree
ssaggregate	ssaggregate
ssccount	ssccount
ssci	ssci
sscpax	sscpax
ssi	ssi
ssizebi	ssizebi
sskapp	sskapp
sslope	sslope
ssm	ssm
ssortedfm	sspecialreg
sspecialreg	sspecialreg
sssplot	sssplot
st2openbugs	st2openbugs
st2openbugsana	st2openbugs
stack	stack
stackedcount	stackedcount
stackedev	stackedev
stackids	mahapick
stackreg	stackreg
staft	staft
staft_pred	staft
staggered	staggered
stak	stak
stan	stan
standsurv	standsurv
starjas	starjas
stat2data	stat2data
stata2pajek	stata2pajek
statacmds	statacmds
stataid	stataid
statapush	statapush
statapushconfig	statapush
statapushpref	statapush
statastates	statastates
statastates_data	statastates
statax	statax
stataxmain	statax
stataxstyle	statax
stataxsyn	statax
stataxversion	statax
statflow	statflow
staticfc	staticfc
statplot	statplot
statsbyfast	statsbyfast
statsmat	statsmat
stbget	stbget
stbrier	stbrier
stbtcalc	stbtcalc
stbtplot	stbtcalc
stcapture	stcapture
stcascoh	stcascoh
stcband	stcband
stcband_example	stcband
stcmd	stcmd
stcomlist	stcomlist
stcompadj	stcompadj
stcompadj_example	stcompadj
stcompet	stcompet
stcoxgof	stcoxgof
stcoxgof_example	stcoxgof
stcoxplt	stcoxplt
stcrmix	stcrmix
stcrprep	stcrprep
stcstat	stcstat
stcstat2	stcstat2
stcumh	stcumh
stdbeta	std_beta
stddiff	stddiff
stddiffi	stddiff
stdn	omninorm
stdtable	stdtable
stdtable_ex	stdtable
step3	step3
stepbic	posw_posis
stepp_plot	mfpi
stepp_tail	mfpi
stepp_window	mfpi
steptest	posw_posis
stexpect	stexpect
stgenreg	stgenreg
stgenreg_d0	stgenreg
stgenreg_gaussquad	stgenreg
stgenreg_pred	stgenreg
stgit	stgit
stgit13	stgit
stgit9	stgit
stgit_error	stgit
stgit_parse	stgit
stgit_summary	stgit
stgtcalc	stgtcalc
stgtplot	stgtcalc
stipw	stipw
stjm	stjm
stjm11	stjm11
stjm11_d0_e	stjm11
stjm11_d0_e_na	stjm11
stjm11_d0_fpm	stjm11
stjm11_d0_fpm_na	stjm11
stjm11_d0_g	stjm11
stjm11_d0_g_na	stjm11
stjm11_d0_w	stjm11
stjm11_d0_w_na	stjm11
stjm11_pred	stjm11
stjm_gaussquad	stjm
stjm_pred	stjm
stjmgraph	stjmgraph
stkap	stkap
stkerhaz	stkerhaz
stlda	stlda
stmd	stmd
stmd2dyn	stmd
stmerlin	merlin
stmix	stmix
stmix_lf_we	stmix
stmix_lf_ww	stmix
stmix_pred	stmix
stmixed	stmixed
stmixed_pred	stmixed
stmt	stmt
stmt_pred	stmt
stndzxage	stndzxage
stnet	stnet
stns	stns
sto	sto
stockcapit	stockcapit
stockquote	stockquote
ston	egenmore
stop	stop
storecmd	storecmd
storecmd6	storecmd
stowcmd	storecmd
stowcmd6	storecmd
stpandoc	dynpandoc
stpepemori	stpepemori
stpepemori_example	stpepemori
stphcoxrcs	stphcoxrcs
stpiece	stpiece
stpm	stpm
stpm2	stpm2
stpm2_centpred	stpm2
stpm2_ml_hazard	stpm2
stpm2_ml_hazard_rs	stpm2
stpm2_ml_lf_hazard	stpm2
stpm2_ml_lf_hazard_rs	stpm2
stpm2_ml_lf_log	stpm2
stpm2_ml_lf_normal_rs	stpm2
stpm2_ml_lf_theta	stpm2
stpm2_ml_lf_theta_rs	stpm2
stpm2_ml_normal	stpm2
stpm2_ml_odds	stpm2
stpm2_ml_odds_rs	stpm2
stpm2_pred	stpm2
stpm2_prefix	stpm2cr
stpm2_standsurv	stpm2_standsurv
stpm2cif	stpm2cif
stpm2cifgq	stpm2cr
stpm2cm	stpm2cm
stpm2cr	stpm2cr
stpm2cr_ml_lf_hazard	stpm2cr
stpm2cr_ml_lf_multi	stpm2cr
stpm2cr_ml_lf_odds	stpm2cr
stpm2cr_pred	stpm2cr
stpm2cr_pred_csh	stpm2cr
stpm2illd	stpm2illd
stpm3	stpm3
stpm3_competing_risks_eg	stpm3
stpm3_fpgen	stpm3
stpm3_gensplines	stpm3
stpm3_polygen	stpm3
stpm3_pred	stpm3
stpm3_predictions_eg	stpm3
stpm3_userfunc	stpm3
stpm3km	stpm3
stpm_p	stpm
stpp	stpp
stpp_example	stpp
stquant	stquant
str2d	str2d
str2ph	xriml
stratarand	stratarand
strbee	strbee
strcs	strcs
strcs_pred	strcs
strdate	strdate
strdist	strdist
streamplot	streamplot
streamplot_crash	streamplot
stregmat	matrixtools
strgen	strgen
strgroup	strgroup
strip	strip
stripfv	icalc
stripolate	mipolate
stripplot	stripplot
strkeep	strkeep
strmst2	strmst2
strmst2pw	strmst2
strofnum	matrixtools
strparse	strparse
strrec	strrec
strsrcs	strsrcs
strsrcs_mlh	strsrcs
strsrcs_mlo	strsrcs
strsrcs_pred	strsrcs
strtonum	matrixtools
stselpre	stselpre
stsurvdiff	stsurvdiff
stsurvimpute	stsurvimpute
sttex	sttex
studenttreg_lf	fmm
studysi	studysi
subinfile	subinfile
subjob11	subsim_2
subjob21	subsim_2
subjob22	subsim_2
subjob23	subsim_2
subjob24	subsim_2
subjob25	subsim_2
subjob31	subsim_2
subjob32	subsim_2
subjob33	subsim_2
subjob34	subsim_2
subjob35	subsim_2
subjob41	subsim_2
subjob42	subsim_2
subjob43	subsim_2
subjob44	subsim_2
subjob45	subsim_2
subjob46	subsim_2
subjob46b	subsim_2
subjob47	subsim_2
subjob48	subsim_2
subjob49	subsim_2
subjobgr1	subsim_2
subjobgr10	subsim_2
subjobgr2	subsim_2
subjobgr3	subsim_2
subjobgr4	subsim_2
subjobgr5	subsim_2
subjobgr6	subsim_2
subjobgr7	subsim_2
subjobgr8	subsim_2
subjobgr9	subsim_2
subjobinc	subsim_2
subjobineq	subsim_2
subjobpov	subsim_2
subjobstat	subsim_1
sublime	sublime
sublist	listutil
subsave	subsave
subselect	matrixtools
subset	subset
subsetbyvif	subsetbyvif
subsetplot	subsetplot
suchowtest	suchowtest
sum2	sum2
sum2docx	sum2docx
sumat	matrixtools
sumby	cart
sumdist	sumdist
sumlist	listutil
summarizeby	summarizeby
summclust	summclust
summdate	summdate
summout	summout
summtab	summtab
summtab2	summtab
summvl	summvl
sumoth	egenmore
sumqi	clarify
sumqoi	more_clarify
sumscale	sumscale
sumstats	sumstats
sumup	sumup
sunburst	sunburst
sunflower	sunflower
supclust	supclust
supercompress	supercompress
supper	sproper
supsmooth	supsmooth
suregr	suregr
suregub	itsp_ado
surface	surface
surface7	surface
surloads	surloads
surrog	surrog
survbound	giniinc
surveybias	surveybias
surveybiasi	surveybias
surveybiasseries	surveybias
survgini	giniinc
survlsl	giniinc
survsim	survsim
survsim_model	survsim
survsim_msm	survsim
survsim_user	survsim
survsim_user_core	survsim
survtime	survtime
survwgt	survwgt
sutex	sutex
sutex2	sutex2
sutex6	sutex
svalue	svalue
svarsirf	svarsirf
svcom	svcom
svcom_run	svcom
svm_ensurelib	svmachines
svm_predict	svmachines
svmachines	svmachines
svmachines_example	svmachines
svmatf	svmatf
svr_disp	svr
svr_get	svr
svr_x	svr
svrcalc	svr
svrcorr	svr
svrest	svr
svresttest	svr
svret	svret
svrlog_p	svr
svrmean	svr
svrmlogit_p	svr
svrmodel	svr
svrologit_p	svr
svrratio	svr
svrset	svr
svrtab	svr
svrtotal	svr
svtxt	svtxt
svtxt_run	svtxt
svvarlbl	svvarlbl
svyatk	svygei_svyatk
svybsamp2	svybsamp2
svycepois	cepois
svygei	svygei_svyatk
svyheckprob2	heckprob2
svylorenz	svylorenz
svymarktouse	marktouse
svypxcat	svypxcat
svypxcon	svypxcon
svysampsi	svysampsi
svysd	svysd
svyselmlog	svyselmlog
svytabform	tabform
svytabs	svytabs
swain	swain
swaini	swain
swapval	swapval
swblock	swblock
swboot	swboot
swindex	swindex
switch	switch
switch_oprobit	switch_oprobit
switch_oprobit_p	switch_oprobit
switchoprobit	switchoprobit
switchoprobit_p	switchoprobit
switchoprobit_work	switchoprobit
switchoprobitsim	switchoprobitsim
switchoprobitsim_p	switchoprobitsim
switchoprobitsim_work	switchoprobitsim
switchr	switchr
swpermute	swpermute
sxpose	sxpose
sxpose2	sxpose2
symbolpalette	palettes
symmetry	symmetry
syn	synlight
syncmrates	syncmrates
syncmrates_1	syncmrates
syncmrates_2	syncmrates
syncmrates_3	syncmrates
synlight	synlight
synlightlist	synlight
synlightversion	synlight
synth	synth
synth2	synth2
synth_ll	synth
sysport	sysport
t2asinh	cdfquantreg
t2burr7	cdfquantreg
t2burr8	cdfquantreg
t2cauchy	cdfquantreg
t2docx	t2docx
t2logistic	cdfquantreg
t2t2	cdfquantreg
t2t2innerv2	cdfquantreg01
t2t2innerv3	cdfquantreg01
t2t2innerw2	cdfquantreg01
t2t2innerw3	cdfquantreg01
t2t2outerv2	cdfquantreg01
t2t2outerv3	cdfquantreg01
t2t2outerw2	cdfquantreg01
t2t2outerw3	cdfquantreg01
t2way5	t2way5
tab2mat	tab2mat
tab2way	tab2way
tab3way	tab3way
taba	taba
tabby	cart
tabchi	tab_chi
tabchii	tab_chi
tabcond	tabcond
tabcount	tabcount
tabcount7	tabcount
tabcusum	tabcusum
tabex	tabex
tabexp	tfr2
tabexport	tabexport
tabform	tabform
tabhbar	tabhbar
tabhplot	tabhplot
tablab	tablab
table1	table1
table1_mc	table1_mc
table1_mc_dta2docx	table1_mc
tablecol	tablecol
tablemat	tablemat
tablepc	tablepc
tableplot	tableplot
tabletutorial_do	tabletutorial
tabm	tab_chi
tabmenu1	effects
tabmenu2	effects
tabmerge	tabmerge
tabmult	tabmult
tabone	tabone
tabout	tabout
tabplot	tabplot
tabplot6	tabplot
tabsheet	tabsheet
tabsort	tab_chi
tabsort6	tab_chi
tabsplit	tab_chi
tabsplit6	tab_chi
tabstat2excel	tabstat2excel
tabstatmat	tabstatmat
tabstatout	tabout
tabtit	subsim_2
tabxml	tabxml
tacts	tacts
tail	tail
takelist	listutil
tarow	tarow
tarowi	tarow
tbl	weaver
tcod	tcod
tddens	tddens
tden	regmain
tdpd	tdpd
ted	ted
tesensitivity	tesensitivity
test_python_plugin	python
test_sandwich	reg_sandwich
testex	testex
testjfe	testjfe
testmnt	testmnt
testout	testout
tevaluator	regmain
tex	texdoc
tex2col	tex2col
tex3pt	tex3pt
tex_equal	tex_equal
texdoc	texdoc
texify	texify
texmerge	texmerge
texresults	texresults
texsave	texsave
textbarplot	textbarplot
textfind	textfind
textgph	textgph
textpad	textpad
tf	lowyseattlea
tfconcat	intext
tfdiff	tfdiff
tfinsert	tfinsert
tfr	lowyseattlea
tfr2	tfr2
tfre	lowyseattlea
tfreq	lowyseattlea
tfv	tfv
tgmixed	tgmixed
tgraph	tgraph
theil	egen_inequal
theildeco	theildeco
theilr2	theilr2
thsearch	thsearch
tic	tictoc
timeit	timeit
timestamp	timestamp
timestamp_zones	timestamp
title	title
tkdensity	tkdensity
tknz	tknz
tlist	lowyseattlea
tlisthead	lowyseattlea
tlogit	clarify
tmap	tmap
tmap_choropleth	tmap
tmap_deviation	tmap
tmap_dot	tmap
tmap_label	tmap
tmap_propsymbol	tmap
tmpdir	tmpdir
tmpinv	tmpinv
tmpm	tmpm
tmpm2	tmpm2
tmvnormal	mvtnorm
tmvnormalden	mvtnorm
tmvt	mvtnorm
tmvtden	mvtnorm
tobexog	probexog-tobexog
tobithetm	tobithetm
tobithetm_lfh	tobithetm
tobithetm_lfn	tobithetm
tobitiv	tobitiv
toc	tictoc
tod	egenmore
todate	todate
todate7	todate
todummies	dummies2
todummy	todummy
tolerance	tolerance
tolerancei	tolerance
tolong	tolong
tolower	tolower
tomata	tomata
tomode	tomode
tone	lowyseattlea
tools_internal	gtools
torats	torats
toroman	roman
torumm	torumm
tosql	tosql
tosql6	tosql
total0	egenmore
touch	touch
toview	lowyseattlea
tpm	tpm
tpm_p	tpm
tpm_svy_check	tpm
tpoisll	tpoisson
tpoisson	tpoisson
tpred	tpred
tpvar	tpvar
tr	tr
traces	traces
trackobs	trackobs
trans2subs	sadi
translog	translog
transplot	transplot
trauma	icdpic
traveltime	traveltime
treatoprobit	treatoprobit
treatoprobit_p	treatoprobit
treatoprobit_work	treatoprobit
treatoprobitsim	treatoprobitsim
treatoprobitsim_p	treatoprobitsim
treatoprobitsim_work	treatoprobitsim
treatrew	treatrew
tree	cart
treecluster	treecluster
treemap	treemap
treeplot	treeplot
treg	regmain
trellis	trellis
trexqua	subsim_2
triangular	groupseq
trimlabs	trimlabs
trimmean	trimmean
trimplot	trimplot
triplot	triplot
triplot6	triplot
triprob_ml	triprobit
triprobit	triprobit
triss	icdpic
trnbin0	trnbin0
trnclist	listutil
trpois0	trpois0
trpoislf	trpois0
trprgr	sadi
truecrypt	truecrypt
truernd	truernd
truncdig	egenmore
try	try
tryem	tryem
tsame	lowyseattlea
tscollap	tscollap
tsegen	tsegen
tsgraph	tsgraph
tslist	tslist
tslstarmod	tslstarmod
tslstarmod_initvals	tslstarmod
tslstarmod_ll	tslstarmod
tslstarmod_p	tslstarmod
tslstarmodtest	tslstarmod
tsmktim	tsmktim
tsplot	tsplot
tsspell	tsspell
tstats	lowyseattlea
tstf	tstf
tsvmat	csdid
ttab	ttab
ttable	ttable
ttable2	ttable2
ttable3	ttable3
tteir	tteir
ttestex	ttestex
ttestex_time	ttestex
ttestplus	ttestplus
ttesttable	ttesttable
ttitle	cart
tuni	icet
tuples	tuples
turbulence	sadi
turnbull	turnbull
tvand	trinary
tvdiff	tvdiff
tvgc	tvgc
tvgc0	tvgc
tvgc_boot	tvgc
tvnot	trinary
tvor	trinary
tw3xls	tw3xls
twby	twby
twby_ex	twby
twed	sadi
twest	twfem
twexp	twexp
twfe	twfe
twfe_p	twfe
twfem	twfem
twgravity	twgravity
twitter2	twitter2stata
twitter2s	twitter2stata
twitter2st	twitter2stata
twitter2sta	twitter2stata
twitter2stat	twitter2stata
twitter2stata	twitter2stata
twload	twfem
twofold	twofold
twopm	twopm
twopm_p	twopm
twopm_svy_check	twopm
twostep	twostep
twostepweakiv	twostepweakiv
twoway__estfit_serset	twoway_estfit
twowayfeweights	twowayfeweights
twres	twfem
twsave	twfem
twset	twfem
txt	weaver
txt2qr	txt2qr
txtlabdef	txtlabdef
txttool	txttool
ua	ua
uc	cart
ucgof	ucgof
uclist	listutil
ucspsplit	ucspsplit
udiff	udiff
udiff_estat	udiff
udiff_lf	udiff
udiff_p	udiff
ueve	ueve
uhdesc	seqlogit
uhdesc10	seqlogit
uirt	uirt
uirt_chi2w	uirt
uirt_dif	uirt
uirt_esf	uirt
uirt_icc	uirt
uirt_inf	uirt
uirt_sim	uirt_sim
uirt_sx2	uirt
uirt_theta	uirt
ultimatch	ultimatch
umbrella	umbrella
umeta	umeta
umetap	umeta
underid	underid
unemp	unemp
unicode2ascii	unicode2ascii
uniq	lowyseattleb
uniqlist	listutil
unique	unique
uniquestrata	uniquestrata
unitab	unitab
unite	tidy
univar	univar
univstat	univstat
upsetplot	upsetplot
uqreg	rif
urcovar	urcovar
usagelog	usagelog
usd	usd
use10	use10
use10reformat	use10
use10save9	use10save9
use13	use13
use13save12	use13save12
usecausaldata	causaldata
usegz	gziputil
usel	lowyseattlea
uselab	uselab
useold	useold
usepackage	usepackage
userprog	userprog
usesas	usesas
usesasdel	usesas
usesome	usesome
usewsz	runmlwin
usexmlex	usexmlex
usexmlex_dlgs	usexmlex
ustrdist	strdist
utest	utest
uvis	ice
v2seats	electool
vaf	vaf
valcuofon_afc	valcuofon
valcuofon_afp	valcuofon
validarcae	validarcae
validarcae_div1	validarcae
validarcae_div2	validarcae
validarcae_div21	validarcae
validarcae_div3	validarcae
validarcae_solve	validarcae
validly	validly
validscale	validscale
vallab	vallab
vallabdef	vallabdef
vallabframe	vallabframe
vallabload	vallabsave
vallabsave	vallabsave
vallabtran	vallabsave
vallist	vallist
valtovar	valtovar
valuesof	valuesof
vam	vam
vanelteren	vanelteren
var	egenmore
var_nr	var_nr
var_nr_fevd	var_nr
var_nr_fevd_bands	var_nr
var_nr_fevd_plot	var_nr
var_nr_hd	var_nr
var_nr_hd_plot	var_nr
var_nr_irf	var_nr
var_nr_irf_bands	var_nr
var_nr_irf_plot	var_nr
var_nr_narr_create	var_nr
var_nr_narr_set	var_nr
var_nr_options	var_nr
var_nr_options_display	var_nr
var_nr_shock_create	var_nr
var_nr_shock_name	var_nr
var_nr_shock_set	var_nr
var_nr_sign_restrict	var_nr
varcase	varcase
vardistinct	vardistinct
varextrema	itsp_ado
varflist	listutil
variancemat	mahapick
variog	variog
variog2	variog
varlab	varlab
varlabdef	varlabdef
varlag	varlag
varlocal	varlocal
varmi	varmi
varprod	varprod
varrets	mvport
varsearch	varsearch
vartyp	vartyp
vbin	vc_pack
vbkw	vbkw
vbkw_main	vbkw
vbkwbstrap	vbkw
vc_bsreg	vc_pack
vc_bw	vc_pack
vc_bw_old	vc_pack
vc_bwalt	vc_pack
vc_bwmt	vc_pack
vc_graph	vc_pack
vc_predict	vc_pack
vc_preg	vc_pack
vc_reg	vc_pack
vc_test	vc_pack
vce2way	vce2way
vcemway	vcemway
vcf	vcf
vclose	vclose
vec_p	varlag
vecar	vecar
vecar6	vecar6
vececm	vececm
vectlist	listutil
vectorof	matrixof
vennbar	vennbar
venndiag	venndiag
veracrypt	veracrypt
vgettoken	vtokenize
viewresults	viewresults
vif2	cmaxuse
vincenty	vincenty
violin	violin
violinplot	violinplot
vioplot	vioplot
vlc	vlc
vlgen	vlgen
vlist	vlist
vm	circular
vmatch	vmatch
vmden	circular
vmerge	vmerge
voronoi	delaunay
vorter	vorter
vplplot	vplplot
vratio	vratio
vreldif	_gvreldif
vreverse	vreverse
vsave	vsave
vselect	vselect
vt_xtoy	vc_pack
vtokenize	vtokenize
vy	validly
w	wordy
waffle	waffle
waffle_plot	waffle_plot
wald_mse	wald_mse
waldtest	boottest
wallplot	depthplot
wangtsiatis	groupseq
warpdenm1	silvermtest
wberr	vc_pack
wbopendata	wbopendata
wbopendata_examples	wbopendata
wbopendata_populate_list	wbopendata
wbull	wbull
wcbregress	wcbregress
wclist	listutil
wclogit	wclogit
wdireshape	wdireshape
wdiscrim	wdiscrim
weakiv	weakiv
weakiv10	weakiv10
weakivtest	weakivtest
weathr	weathr
weave	weaver
weavend	weaver
weavercheck	weaver
weavercontroller	weaver
weaverjquery	weaver
weavermarkup	weaver
weavermath	weaver
weaverstyle	weaver
weaverversion	weaver
weaverwkhtmltopdf	weaver
weaverzoom	weaver
webdoc	webdoc
webimage	webimage
webuse10	use10
weeklyclaims	weeklyclaims
weibull_leftcensor	giniinc
weibull_lefttrunc	giniinc
weibullfit	weibullfit
weibullfit_lf	weibullfit
welflossas	welflossas
wexamples	examples
wgtcellcollapse	ipfraking
wgttest	wgttest
whatsdeff	ipfraking
whereis	whereis
which_edit	matrixtools
which_version	which_version
whichencoding	unicode2ascii
whichlist	whichlist
whichpkg	whichpkg
white	white
whitetst	whitetst
whittle	whittle
whotdeck	whotdeck
wid	wid
wid_example1	wid
wid_example2	wid
wid_example3	wid
williams	williams
windowsmonitor	windowsmonitor
winratio	winratio
winratiotest	winratiotest
winsor	winsor
winsor2	winsor2
witch	witch
wjtest	johans
wmean	_gwmean
wntestq2	panelauto
wntstmvq	wntstmvq
wo	wordy
wor	wordy
word	wordy
wordcb	wordcb
wordconvert	wordconvert
wordof	egenmore
wordy	wordy
wordy1	wordy
wordy2	wordy
wordy3	wordy
wordy4	wordy
wordy5	wordy
workdays	workdays
worldstat	worldstat
wosaddress	wosaddress
wosload	wosload
wpctile	egenmore
wridit	wridit
writeinput	writeinput
writekml	writekml
writepsfrag	writepsfrag
wtd	wtd
wtd_is	wtd
wtd_loglik	wtd
wtd_perc	wtd_perc
wtd_set	wtd
wtd_show	wtd
wtddiag	wtd
wtdml	wtd
wtdpred	wtd
wtdq	wtd
wtdset	wtd
wtdttt	wtdttt
wtdtttdiag	wtdttt
wtdtttpreddur	wtdttt
wtdtttpredprob	wtdttt
wtfreq	egenmore
wtmean	_gwtmean
wtp	wtp
wtpcikr	wtpcikr
wtpkrinsky	wtpcikr
wtpmeasure	wtpcikr
wyoung	wyoung
xauto	xauto
xb2pi	xb2pi
xbalance	xbalance
xbrcspline	xbrcspline
xcollapse	xcollapse
xcontract	xcontract
xcorplot	xcorplot
xdatelist	xdatelist
xdir	xdir
xfrac	xfrac
xfrac_154	boxtid
xfrac_adj	boxtid
xfrac_chk	boxtid
xfrac_dis	boxtid
xfracplot	boxtid
xfracpoly	mfpigen
xfracpred	boxtid
xframeappend	xframeappend
xframedir	xdir
xglm	xglm
xgroup	xgroup
xlincom	xlincom
xlincom_p	xlincom
xls2dta	xls2dta
xls2row	ipfraking
xmfp	mfpigen
xmiss	xmiss
xml_tab	xml_tab
xml_taba2	subsim_2
xorlist	listutil
xpredict	xpredict
xrelong	xrewide
xrewide	xrewide
xri_egll	xriml
xri_enll	xriml
xri_mell	xriml
xri_mpll	xriml
xri_nll	xriml
xri_pnll	xriml
xri_slll	xriml
xrigls	xrigls
xriml	xriml
xripred	xriml
xsampsi	xsampsi
xsmle	xsmle
xsmle_p	xsmle
xsvmat	xsvmat
xtab	xtab
xtab2_p	xtabond2
xtable	xtable
xtabond2	xtabond2
xtarimau	xtarimau
xtarsim	xtarsim
xtart	xtfeis
xtavplot	xtavplot
xtavplots	xtavplot
xtbalance	xtbalance
xtbalance2	xtbalance2
xtbcfe	xtbcfe
xtbcfe_p	xtbcfe
xtbreak	xtbreak
xtbreak_auxiliary	xtbreak
xtbreak_estat	xtbreak
xtbreak_estimate	xtbreak
xtbreak_tests	xtbreak
xtbsht	xtfeis
xtbunitroot	xtbunitroot
xtcaec	xtcaec
xtcce	xtcce
xtcd	xtcd
xtcd2	xtcd2
xtcdf	xtcdf
xtcenter	xtcenter
xtcips	xtcips
xtcointreg	xtcointreg
xtcsd	xtcsd
xtcse2	xtcse2
xtcsi	xtcsi
xtdcce2	xtdcce2
xtdcce2_auxiliary	xtcd2
xtdcce2_estat	xtdcce2
xtdcce2_p	xtdcce2
xtdcce2fast	xtdcce2
xtdolshm	xtdolshm
xtdolshm_p	xtdolshm
xtdpdbc	xtdpdbc
xtdpdbc_estat	xtdpdbc
xtdpdbc_p	xtdpdbc
xtdpdgmm	xtdpdgmm
xtdpdgmm_estat	xtdpdgmm
xtdpdgmm_p	xtdpdgmm
xtdpdgmmfe	xtdpdgmm
xtdpdml	xtdpdml
xtdpdqml	xtdpdqml
xtdpdqml_estat	xtdpdqml
xtdpdqml_p	xtdpdqml
xtendothresdpd	xtendothresdpd
xtendothresdpd_p	xtendothresdpd
xtendothresdpdboot	xtendothresdpd
xtendothresdpdconv	xtendothresdpd
xtendothresdpdfmoy	xtendothresdpd
xtendothresdpdfod	xtendothresdpd
xtendothresdpdtest	xtendothresdpd
xteurostat	xteurostat
xtevent	xtevent
xteventplot	xtevent
xteventtest	xtevent
xtewreg	xtewreg
xtfeis	xtfeis
xtfisher	xtfisher
xtfixedcoeftvcu	xtfixedcoeftvcu
xtfixedcoeftvcu_p	xtfixedcoeftvcu
xtfmb	xtfmb
xtgcause	xtgcause
xtgeebcv	xtgeebcv
xtglsr	xtglsr
xtgrangert	xtgrangert
xtgrangert_p	xtgrangert
xtgraph	xtgraph
xtheckmanfe	xtheckmanfe
xtheckmanfe_ml	xtheckmanfe
xthrtest	xthrtest
xthst	xthst
xthybrid	xthybrid
xtidt	xtidt
xtile	egenmore
xtile2	xtile2
xtilel	lowyseattleb
xtiletest	xtiletest
xtimportu	xtimportu
xtine	xtine
xtistest	xtistest
xtitsa	xtitsa
xtivdfreg	xtivdfreg
xtivdfreg_estat	xtivdfreg
xtivdfreg_p	xtivdfreg
xtivreg2	xtivreg2
xtivreg28	xtivreg28
xtivreg2_p	xtivreg2
xtkr	xtkr
xtlhazard	xtlhazard
xtlsdvc	xtlsdvc
xtlsdvc_1	xtlsdvc
xtlsdvc_b	xtlsdvc
xtlsdvc_p	xtlsdvc
xtmg	xtmg
xtmipolateu	xtmipolateu
xtmis	xtmis
xtmixed_corr	xtmixed_corr
xtmixediou	xtmixediou
xtmixediou_display	xtmixediou
xtmixediou_sv	xtmixediou
xtmixedioupredict	xtmixediou
xtmod	xtmod
xtmoran	xtmoran
xtmrho	xtmrho
xtnptimevar	xtnptimevar
xtnptimevaravecb	xtnptimevar
xtnptimevarsansb	xtnptimevar
xtnumfac	xtnumfac
xtoos_bin_i	xtoos
xtoos_bin_t	xtoos
xtoos_i	xtoos
xtoos_t	xtoos
xtoverid	xtoverid
xtpattern	xtpattern
xtpatternvar	xtpatternvar
xtpdyn	xtpdyn
xtpedroni	xtpedroni
xtpmg	xtpmg
xtpmg_ml	xtpmg
xtpqml	xtpqml
xtprobitunbal	xtprobitunbal
xtpsse	xtpsse
xtqptest	xtqptest
xtqreg	xtqreg
xtregam	xtregam
xtregbem	xtregbem
xtregbn	xtregbn
xtregcluster	xtregcluster
xtregdhp	xtregdhp
xtregfem	xtregfem
xtreghet	xtreghet
xtreghet_lfh	xtreghet
xtreghet_lfn	xtreghet
xtregmle	xtregmle
xtregre2	xtregre2
xtregrem	xtregrem
xtregsam	xtregsam
xtregtwo	xtregtwo
xtregwem	xtregwem
xtregwhm	xtregwhm
xtrobreg	xtrobreg
xtscc	xtscc
xtscc_p	xtscc
xtselmod	xtsel
xtselvar	xtsel
xtsemipar	xtsemipar
xtseqreg	xtseqreg
xtseqreg_estat	xtseqreg
xtseqreg_p	xtseqreg
xtserialpm	xtserialpm
xtset2	xtcd2
xtsfkk	xtsfkk
xtspecialreg	sspecialreg
xtspj	xtspj
xtss	xtss
xtstackreg	stackreg
xtstfetchcovid19	xtstfetchcovid19
xtsum2docx	xtsum2docx
xtsur	xtsur
xttest2	xttest2
xttest3	xttest3
xttrans2	xttrans2
xtusreg	xtusreg
xtvar	xtvar
xtvc	xtvc
xtwest	xtwest
xvalols	xvalols
yrdif	yrdif
yxview_parea_draw	twoway_parea
zandrews	zandrews
zb_qrm	zb_qrm
zboot	isograph
zcq	zcq
zerouse	digits
zib_lf	zoib
zicen	zicen
zicen0	zicen
zicen2_lf	zicen
zicen2_p	zicen
zicen3_lf	zicen
zicen3_p	zicen
zicenec	zicen
zicenlc	zicen
zinb	zinb
zinb_ll	zinb
zip	zip
zip_ll	zip
zipappend	zipsave
zipf	zipffit
zipf_mandelbrot	zipffit
zipffit	zipffit
zipmerge	zipsave
zippkg	zippkg
zippred	zip
zipsave	zipsave
zipsaveold	zipsave
zipuse	zipsave
zmap	zmap
zoib	zoib
zoib_beta_lf	zoib
zoib_lf	zoib
zoib_p	zoib
zscore06	zscore06
ztg	ztg
ztnbp	ztnbp
ztnbp_ll	ztnbp
ztpflex	ztpflex
ztpflex_ada_ll	ztpflex
ztpflex_ll	ztpflex
